id,truncated,total connections,actual connections,appearance count,correct appearances,incorrect appearances
2,False,47,48,48,0,48
3,False,67,68,50,0,50
4,False,10,11,33,1,32
5,False,11,12,11,0,11
6,True,1441,500,1017,16,1001
7,False,28,29,57,1,56
8,False,79,80,50,10,40
9,False,77,78,29,3,26
10,False,29,30,26,1,25
11,True,1776,500,759,251,508
12,False,13,14,9,0,9
13,True,1787,500,895,322,573
14,False,41,42,42,0,42
15,False,57,58,30,1,29
16,False,167,168,103,0,103
17,False,35,36,38,0,38
18,False,79,80,66,1,65
19,False,92,93,47,0,47
20,False,140,141,57,4,53
21,False,274,275,110,6,104
22,False,94,95,42,0,42
23,False,38,39,40,0,40
24,False,53,54,68,0,68
25,True,1388,500,1104,24,1080
26,False,38,39,70,0,70
27,False,33,34,41,1,40
28,False,87,88,129,0,129
29,False,389,390,309,3,306
30,False,32,33,40,0,40
31,False,146,147,116,1,115
32,False,119,120,89,1,88
33,False,78,79,80,0,80
34,True,7614,500,6629,176,6453
35,False,6,7,13,0,13
36,False,63,64,53,1,52
37,False,52,53,46,0,46
38,False,30,31,51,1,50
39,False,89,90,51,1,50
40,False,41,42,52,0,52
41,False,185,186,149,1,148
42,False,43,44,49,0,49
43,False,52,53,51,0,51
44,False,22,23,15,0,15
45,False,195,196,192,4,188
46,False,98,99,76,0,76
47,False,15,16,6,0,6
48,False,255,256,170,0,170
49,False,17,18,6,1,5
50,False,35,36,13,0,13
51,False,31,32,11,0,11
52,False,40,41,20,0,20
53,False,7,8,4,0,4
54,False,41,42,15,0,15
55,False,111,112,126,0,126
56,False,75,76,66,0,66
57,False,69,70,38,0,38
58,False,49,50,41,1,40
59,False,165,166,112,3,109
60,False,35,36,31,0,31
61,False,20,21,4,0,4
62,False,291,292,203,1,202
63,False,39,40,21,0,21
64,True,3612,500,3176,44,3132
65,False,50,51,157,1,156
66,True,807,500,577,6,571
67,False,124,125,72,0,72
68,False,78,79,52,2,50
69,False,66,67,39,2,37
70,False,421,422,255,3,252
71,False,119,120,84,0,84
72,False,127,128,101,1,100
73,False,49,50,34,0,34
74,False,49,50,34,0,34
75,False,53,54,31,0,31
76,False,37,38,13,0,13
77,False,429,430,303,1,302
78,False,38,39,49,0,49
79,False,182,183,130,1,129
80,False,29,30,33,0,33
81,False,42,43,48,1,47
82,False,168,169,147,3,144
83,False,56,57,88,6,82
84,False,32,33,18,2,16
85,False,29,30,15,0,15
86,False,468,469,318,3,315
87,False,147,148,99,2,97
88,False,35,36,22,0,22
89,False,114,115,76,0,76
90,False,56,57,22,0,22
91,False,4,5,37,0,37
92,True,4286,500,3883,184,3699
93,False,59,60,67,2,65
94,False,414,415,244,2,242
95,False,32,33,12,0,12
96,False,41,42,25,0,25
97,False,152,153,186,1,185
98,False,19,20,9,0,9
99,False,259,260,107,30,77
100,False,119,120,76,0,76
101,False,20,21,9,0,9
102,False,52,53,80,0,80
103,False,108,109,62,0,62
104,False,16,17,65,0,65
105,False,71,72,59,2,57
106,False,30,31,17,0,17
107,False,95,96,102,1,101
108,False,208,209,119,2,117
109,False,55,56,52,0,52
110,False,17,18,9,0,9
111,False,41,42,25,0,25
112,False,14,15,11,0,11
113,False,50,51,49,0,49
114,False,400,401,253,0,253
115,False,45,46,36,0,36
116,False,44,45,51,0,51
117,False,49,50,22,0,22
118,False,20,21,13,2,11
119,True,1491,500,731,206,525
120,False,59,60,44,0,44
121,True,724,500,449,5,444
122,False,36,37,36,0,36
123,False,27,28,11,1,10
124,False,10,11,3,1,2
125,False,43,44,68,0,68
126,False,416,417,189,4,185
127,False,100,101,48,0,48
128,False,71,72,58,0,58
129,False,26,27,15,1,14
130,False,83,84,70,0,70
131,False,23,24,18,0,18
132,False,27,28,24,0,24
133,False,289,290,224,1,223
134,False,91,92,105,7,98
135,False,51,52,43,1,42
136,False,8,9,14,1,13
137,False,40,41,42,0,42
138,False,430,431,321,5,316
139,False,41,42,65,0,65
140,True,1189,500,541,9,532
141,True,505,500,191,4,187
142,False,75,76,50,0,50
143,True,2928,500,2646,39,2607
144,False,8,9,7,0,7
145,False,10,11,1,0,1
146,False,67,68,33,0,33
147,False,170,171,143,10,133
148,False,30,31,32,0,32
149,False,118,119,103,1,102
150,False,41,42,23,0,23
151,False,75,76,78,1,77
152,False,86,87,77,0,77
153,False,5,6,7,0,7
154,False,55,56,96,1,95
155,False,77,78,28,0,28
156,False,100,101,67,0,67
157,False,52,53,51,0,51
158,False,36,37,49,2,47
159,False,42,43,46,0,46
160,True,629,500,441,7,434
161,False,91,92,112,1,111
162,True,2675,500,2091,36,2055
163,False,11,12,4,0,4
164,False,32,33,50,1,49
165,True,610,500,465,7,458
166,False,48,49,24,1,23
167,False,15,16,9,0,9
168,False,148,149,131,0,131
169,False,36,37,46,3,43
170,False,36,37,40,0,40
171,False,86,87,88,0,88
172,False,17,18,9,0,9
173,False,64,65,36,1,35
174,False,58,59,55,0,55
175,False,17,18,78,0,78
176,False,40,41,31,0,31
177,False,12,13,47,0,47
178,False,61,62,29,5,24
179,False,115,116,105,16,89
180,False,34,35,13,0,13
181,False,106,107,63,1,62
182,False,31,32,38,0,38
183,True,877,500,642,23,619
184,False,54,55,30,0,30
185,False,83,84,60,0,60
186,False,36,37,25,0,25
187,False,31,32,17,0,17
188,False,242,243,151,1,150
189,False,22,23,14,0,14
190,False,46,47,24,1,23
191,False,66,67,34,0,34
192,False,65,66,64,1,63
193,False,4,5,8,0,8
194,False,35,36,31,0,31
195,False,49,50,48,1,47
196,False,56,57,71,2,69
197,False,21,22,40,0,40
198,False,88,89,45,0,45
199,False,73,74,46,1,45
200,False,46,47,18,0,18
201,False,7,8,5,0,5
202,False,209,210,120,0,120
203,False,84,85,68,0,68
204,True,516,500,314,4,310
205,False,11,12,40,1,39
206,False,30,31,42,0,42
207,False,190,191,164,3,161
208,False,97,98,93,3,90
209,False,12,13,2,0,2
210,False,87,88,76,3,73
211,False,170,171,121,1,120
212,False,381,382,158,5,153
213,True,612,500,207,12,195
214,True,845,500,450,11,439
215,False,36,37,34,0,34
216,False,32,33,21,1,20
217,True,864,500,729,7,722
218,False,20,21,72,4,68
219,False,10,11,22,0,22
220,False,25,26,25,0,25
221,False,81,82,120,0,120
222,False,64,65,47,1,46
223,False,33,34,29,0,29
224,False,17,18,71,0,71
225,False,50,51,28,0,28
226,False,139,140,128,1,127
227,False,14,15,37,2,35
228,False,421,422,435,4,431
229,False,38,39,16,0,16
230,False,79,80,69,1,68
231,False,49,50,42,0,42
232,False,38,39,27,0,27
233,False,19,20,41,0,41
234,False,59,60,33,1,32
235,False,117,118,58,0,58
236,False,43,44,36,1,35
237,False,201,202,124,0,124
238,True,636,500,626,8,618
239,False,24,25,62,1,61
240,False,11,12,2,0,2
241,False,35,36,29,0,29
242,False,154,155,116,0,116
243,False,34,35,45,1,44
244,False,28,29,9,1,8
245,False,441,442,395,6,389
246,False,52,53,19,3,16
247,False,46,47,19,0,19
248,False,41,42,28,0,28
249,False,74,75,31,0,31
250,False,53,54,27,0,27
251,False,464,465,377,7,370
252,False,25,26,36,0,36
253,False,86,87,65,0,65
254,False,39,40,45,0,45
255,False,39,40,10,0,10
256,False,83,84,43,7,36
257,False,129,130,89,0,89
258,False,75,76,40,1,39
259,False,42,43,29,0,29
260,False,58,59,57,0,57
261,False,129,130,95,0,95
262,False,94,95,51,0,51
263,False,108,109,93,2,91
264,False,29,30,75,0,75
265,False,27,28,31,0,31
266,False,60,61,39,0,39
267,False,27,28,15,0,15
268,False,56,57,38,1,37
269,False,39,40,22,0,22
270,True,538,500,417,6,411
271,False,34,35,22,0,22
272,False,196,197,171,1,170
273,False,123,124,73,1,72
274,False,62,63,28,1,27
275,False,66,67,40,0,40
276,True,661,500,419,11,408
277,False,97,98,45,0,45
278,False,36,37,39,1,38
279,False,17,18,12,0,12
280,False,57,58,58,0,58
281,False,106,107,53,2,51
282,False,78,79,69,2,67
283,False,102,103,59,1,58
284,False,84,85,57,0,57
285,False,45,46,37,0,37
286,False,136,137,134,1,133
287,False,182,183,137,0,137
288,False,14,15,6,0,6
289,False,156,157,130,5,125
290,False,13,14,99,2,97
291,False,130,131,73,0,73
292,False,70,71,107,0,107
293,False,57,58,37,0,37
294,False,46,47,71,5,66
295,False,180,181,133,2,131
296,False,7,8,3,0,3
297,False,25,26,40,0,40
298,False,85,86,64,1,63
299,False,73,74,77,7,70
300,False,45,46,23,0,23
301,False,162,163,56,3,53
302,False,22,23,20,0,20
303,False,57,58,61,0,61
304,False,131,132,59,2,57
305,False,42,43,56,0,56
306,False,21,22,53,0,53
307,False,45,46,90,5,85
308,False,44,45,44,1,43
309,False,61,62,38,1,37
310,False,420,421,394,8,386
311,False,43,44,44,0,44
312,False,381,382,154,6,148
313,False,45,46,13,0,13
314,False,39,40,27,0,27
315,False,120,121,111,1,110
316,False,43,44,33,0,33
317,False,33,34,23,0,23
318,False,90,91,35,3,32
319,False,81,82,72,4,68
320,False,20,21,6,0,6
321,False,18,19,3,0,3
322,False,108,109,64,6,58
323,False,27,28,18,0,18
324,False,56,57,32,0,32
325,False,91,92,48,0,48
326,False,100,101,81,1,80
327,False,8,9,3,0,3
328,False,138,139,146,2,144
329,False,130,131,75,0,75
330,False,53,54,43,5,38
331,False,85,86,29,0,29
332,False,134,135,88,0,88
333,False,449,450,259,9,250
334,False,12,13,11,0,11
335,False,107,108,77,0,77
336,False,28,29,16,1,15
337,False,39,40,34,0,34
338,False,12,13,7,0,7
339,False,33,34,23,0,23
340,False,28,29,33,0,33
341,False,40,41,22,1,21
342,False,60,61,85,1,84
343,False,35,36,32,1,31
344,True,703,500,528,8,520
345,False,20,21,12,2,10
346,False,425,426,259,16,243
347,False,42,43,28,0,28
348,False,75,76,53,1,52
349,False,69,70,47,1,46
350,False,28,29,9,0,9
351,False,47,48,34,0,34
352,False,33,34,34,0,34
353,False,14,15,6,0,6
354,False,95,96,85,0,85
355,False,50,51,47,0,47
356,False,26,27,17,0,17
357,False,60,61,46,0,46
358,False,391,392,291,0,291
359,False,60,61,37,0,37
360,False,123,124,61,0,61
361,False,40,41,44,0,44
362,False,131,132,99,1,98
363,False,96,97,54,0,54
364,False,11,12,25,0,25
365,False,84,85,74,0,74
366,False,80,81,71,2,69
367,False,69,70,66,6,60
368,False,97,98,103,2,101
369,False,208,209,212,0,212
370,False,36,37,18,0,18
371,False,30,31,14,0,14
372,False,49,50,64,0,64
373,False,304,305,211,1,210
374,False,24,25,42,1,41
375,False,16,17,53,4,49
376,False,76,77,57,0,57
377,False,149,150,84,0,84
378,False,62,63,64,3,61
379,False,104,105,103,1,102
380,False,60,61,30,0,30
381,False,34,35,63,0,63
382,False,41,42,60,0,60
383,False,62,63,36,0,36
384,True,1953,500,1405,26,1379
385,False,84,85,55,0,55
386,True,811,500,689,9,680
387,False,49,50,14,2,12
388,False,110,111,42,3,39
389,False,46,47,62,0,62
390,False,27,28,21,1,20
391,False,54,55,38,2,36
392,False,106,107,133,0,133
393,False,49,50,33,0,33
394,False,63,64,82,1,81
395,True,609,500,487,7,480
396,False,130,131,92,1,91
397,False,32,33,18,0,18
398,False,52,53,53,4,49
399,False,45,46,11,0,11
400,False,16,17,9,1,8
401,True,1740,500,929,343,586
402,False,23,24,39,0,39
403,False,16,17,28,0,28
404,False,20,21,10,0,10
405,False,41,42,18,0,18
406,False,20,21,52,1,51
407,False,6,7,3,0,3
408,False,77,78,53,0,53
409,False,135,136,115,2,113
410,False,39,40,26,0,26
411,False,58,59,59,0,59
412,False,391,392,302,0,302
413,False,46,47,18,0,18
414,False,18,19,57,0,57
415,False,12,13,40,1,39
416,False,37,38,18,0,18
417,False,50,51,17,0,17
418,False,31,32,30,0,30
419,False,43,44,69,0,69
420,False,20,21,61,1,60
421,False,271,272,228,5,223
422,False,185,186,125,3,122
423,False,8,9,13,0,13
424,False,15,16,48,0,48
425,False,17,18,8,0,8
426,False,46,47,46,0,46
427,False,58,59,54,1,53
428,False,34,35,27,0,27
429,False,28,29,42,0,42
430,False,76,77,27,0,27
431,False,64,65,65,3,62
432,False,62,63,34,0,34
433,False,27,28,10,0,10
434,False,69,70,50,1,49
435,False,55,56,22,0,22
436,True,2992,500,2760,41,2719
437,False,79,80,43,0,43
438,False,43,44,20,0,20
439,False,132,133,46,3,43
440,False,30,31,52,0,52
441,False,160,161,126,2,124
442,False,75,76,73,0,73
443,False,360,361,285,2,283
444,False,57,58,31,0,31
445,False,25,26,37,0,37
446,False,31,32,38,0,38
447,False,14,15,7,0,7
448,False,50,51,31,0,31
449,False,118,119,99,0,99
450,False,38,39,17,0,17
451,False,411,412,296,2,294
452,False,103,104,38,0,38
453,False,10,11,8,0,8
454,False,35,36,11,0,11
455,False,44,45,63,2,61
456,False,25,26,8,0,8
457,False,42,43,41,1,40
458,False,32,33,46,0,46
459,False,458,459,353,2,351
460,False,38,39,42,0,42
461,False,21,22,42,0,42
462,False,96,97,72,0,72
463,False,36,37,37,0,37
464,False,36,37,37,0,37
465,False,77,78,57,0,57
466,False,17,18,4,0,4
467,False,27,28,35,0,35
468,False,250,251,180,0,180
469,False,429,430,297,1,296
470,False,26,27,23,0,23
471,False,47,48,29,0,29
472,False,277,278,199,2,197
473,False,92,93,67,1,66
474,False,57,58,32,2,30
475,False,65,66,33,1,32
476,False,154,155,88,0,88
477,False,124,125,81,1,80
478,False,20,21,23,1,22
479,False,14,15,4,0,4
480,False,44,45,28,4,24
481,False,257,258,92,2,90
482,False,142,143,35,1,34
483,False,50,51,32,0,32
484,False,101,102,79,1,78
485,False,155,156,95,0,95
486,False,135,136,166,4,162
487,False,31,32,22,0,22
488,False,39,40,15,0,15
489,False,21,22,19,0,19
490,False,51,52,38,0,38
491,False,28,29,23,0,23
492,False,90,91,80,2,78
493,False,144,145,45,0,45
494,False,120,121,58,0,58
495,False,66,67,57,3,54
496,False,362,363,318,5,313
497,False,51,52,33,1,32
498,False,44,45,14,0,14
499,False,32,33,54,1,53
500,False,33,34,41,0,41
501,False,157,158,67,2,65
502,False,61,62,45,0,45
503,False,14,15,16,1,15
504,False,141,142,101,0,101
505,False,48,49,30,0,30
506,False,37,38,19,0,19
507,False,28,29,53,0,53
508,False,198,199,85,3,82
509,False,38,39,11,0,11
510,False,41,42,25,0,25
511,False,11,12,11,0,11
512,False,20,21,16,1,15
513,False,32,33,45,0,45
514,False,36,37,39,2,37
515,False,102,103,66,5,61
516,False,42,43,60,0,60
517,False,32,33,24,0,24
518,False,18,19,14,0,14
519,False,39,40,51,1,50
520,False,64,65,92,3,89
521,False,16,17,29,4,25
522,False,22,23,22,3,19
523,False,367,368,267,6,261
524,False,59,60,33,0,33
525,False,40,41,75,0,75
526,False,47,48,43,0,43
527,False,62,63,47,0,47
528,False,77,78,42,0,42
529,False,160,161,87,0,87
530,False,38,39,21,0,21
531,False,341,342,277,6,271
532,False,37,38,60,0,60
533,False,13,14,58,2,56
534,False,37,38,37,1,36
535,False,29,30,24,0,24
536,False,20,21,11,1,10
537,False,34,35,15,0,15
538,False,246,247,143,0,143
539,False,74,75,53,5,48
540,False,34,35,17,0,17
541,False,11,12,6,0,6
542,False,90,91,92,0,92
543,False,55,56,26,1,25
544,False,40,41,20,2,18
545,False,104,105,86,1,85
546,False,29,30,18,1,17
547,False,165,166,118,0,118
548,False,23,24,11,0,11
549,False,70,71,56,2,54
550,False,67,68,53,6,47
551,False,36,37,21,0,21
552,False,106,107,53,0,53
553,False,35,36,14,0,14
554,False,64,65,61,0,61
555,False,74,75,52,0,52
556,False,40,41,44,0,44
557,False,45,46,13,1,12
558,False,15,16,5,0,5
559,False,111,112,117,2,115
560,False,75,76,74,1,73
561,True,588,500,359,3,356
562,False,43,44,38,10,28
563,False,57,58,12,0,12
564,False,31,32,23,0,23
565,False,62,63,45,0,45
566,False,45,46,86,0,86
567,False,40,41,30,0,30
568,False,18,19,15,0,15
569,False,21,22,23,0,23
570,False,94,95,69,0,69
571,False,59,60,37,0,37
572,True,714,500,333,4,329
573,False,19,20,5,0,5
574,False,55,56,34,0,34
575,False,52,53,30,0,30
576,False,72,73,37,0,37
577,False,27,28,20,0,20
578,False,44,45,66,0,66
579,False,51,52,54,1,53
580,False,194,195,150,2,148
581,False,121,122,50,1,49
582,False,97,98,98,1,97
583,False,9,10,1,0,1
584,False,100,101,39,1,38
585,False,64,65,17,3,14
586,False,18,19,8,0,8
587,False,182,183,133,2,131
588,False,12,13,7,2,5
589,False,118,119,91,1,90
590,False,155,156,136,1,135
591,False,47,48,56,1,55
592,False,8,9,8,0,8
593,False,21,22,32,1,31
594,True,1077,500,961,8,953
595,False,72,73,61,0,61
596,False,113,114,73,1,72
597,False,141,142,105,0,105
598,False,31,32,42,0,42
599,False,394,395,121,8,113
600,False,314,315,218,1,217
601,False,35,36,16,0,16
602,False,69,70,41,0,41
603,False,238,239,187,0,187
604,False,28,29,51,1,50
605,False,33,34,41,0,41
606,False,41,42,33,0,33
607,False,9,10,16,0,16
608,False,46,47,74,0,74
609,False,152,153,110,0,110
610,False,97,98,77,1,76
611,False,28,29,22,0,22
612,False,49,50,33,0,33
613,False,113,114,125,3,122
614,False,51,52,31,0,31
615,False,57,58,27,0,27
616,False,29,30,29,0,29
617,False,95,96,34,0,34
618,False,41,42,43,0,43
619,False,5,6,10,0,10
620,False,44,45,26,0,26
621,False,31,32,50,0,50
622,False,21,22,18,0,18
623,False,16,17,44,0,44
624,False,316,317,232,3,229
625,False,97,98,48,0,48
626,False,48,49,25,0,25
627,False,83,84,90,2,88
628,False,197,198,107,3,104
629,False,74,75,23,1,22
630,False,95,96,46,6,40
631,False,81,82,54,0,54
632,False,60,61,35,0,35
633,False,120,121,72,1,71
634,False,150,151,94,9,85
635,False,36,37,43,0,43
636,False,41,42,30,0,30
637,False,36,37,41,0,41
638,False,213,214,222,0,222
639,True,982,500,648,18,630
640,False,7,8,28,5,23
641,False,55,56,23,0,23
642,False,243,244,149,2,147
643,False,71,72,97,0,97
644,False,113,114,62,0,62
645,False,31,32,58,1,57
646,False,22,23,16,0,16
647,False,57,58,31,1,30
648,False,25,26,17,0,17
649,False,76,77,93,0,93
650,False,7,8,5,0,5
651,False,38,39,25,0,25
652,False,27,28,46,0,46
653,False,34,35,90,1,89
654,False,32,33,18,0,18
655,False,58,59,56,0,56
656,False,14,15,12,0,12
657,False,80,81,55,0,55
658,False,84,85,81,0,81
659,False,446,447,341,3,338
660,True,641,500,513,8,505
661,False,36,37,27,0,27
662,False,45,46,25,1,24
663,False,51,52,51,1,50
664,False,30,31,72,0,72
665,False,69,70,35,0,35
666,False,32,33,15,0,15
667,False,59,60,35,1,34
668,False,35,36,23,0,23
669,False,73,74,36,4,32
670,False,69,70,58,4,54
671,False,62,63,67,1,66
672,False,98,99,107,3,104
673,False,152,153,148,2,146
674,False,86,87,61,1,60
675,False,62,63,79,1,78
676,False,63,64,52,3,49
677,False,50,51,21,0,21
678,False,38,39,56,1,55
679,False,63,64,47,0,47
680,False,57,58,60,0,60
681,False,40,41,32,0,32
682,False,19,20,5,0,5
683,False,35,36,91,0,91
684,False,65,66,61,1,60
685,False,53,54,47,0,47
686,False,6,7,5,0,5
687,False,2,3,0,0,0
688,False,119,120,113,2,111
689,False,83,84,75,0,75
690,False,95,96,47,1,46
691,False,99,100,103,0,103
692,False,48,49,43,0,43
693,False,71,72,35,2,33
694,False,60,61,60,5,55
695,False,39,40,27,0,27
696,False,72,73,43,1,42
697,False,10,11,1,0,1
698,False,12,13,13,0,13
699,False,13,14,16,0,16
700,False,34,35,76,0,76
701,False,78,79,76,0,76
702,False,20,21,55,0,55
703,False,31,32,15,0,15
704,False,12,13,3,2,1
705,False,53,54,54,3,51
706,False,20,21,18,0,18
707,False,60,61,77,4,73
708,False,371,372,394,4,390
709,False,20,21,6,1,5
710,False,107,108,44,0,44
711,False,90,91,26,1,25
712,False,17,18,8,0,8
713,False,105,106,70,0,70
714,False,16,17,3,0,3
715,False,24,25,60,0,60
716,False,50,51,32,0,32
717,False,67,68,62,1,61
718,False,49,50,58,0,58
719,False,45,46,30,0,30
720,False,11,12,6,0,6
721,False,31,32,12,0,12
722,False,61,62,55,1,54
723,False,82,83,54,0,54
724,False,34,35,75,0,75
725,False,25,26,38,0,38
726,False,47,48,60,1,59
727,False,24,25,19,0,19
728,False,181,182,60,8,52
729,False,61,62,36,1,35
730,False,46,47,42,1,41
731,False,32,33,19,0,19
732,False,19,20,26,0,26
733,False,23,24,10,0,10
734,False,32,33,15,0,15
735,False,89,90,73,0,73
736,False,22,23,9,1,8
737,False,143,144,31,0,31
738,False,19,20,5,0,5
739,False,90,91,85,3,82
740,False,38,39,39,1,38
741,False,115,116,98,0,98
742,False,89,90,72,0,72
743,False,13,14,33,0,33
744,False,457,458,366,1,365
745,False,44,45,53,2,51
746,False,40,41,48,0,48
747,False,131,132,93,2,91
748,False,97,98,94,3,91
749,False,165,166,120,0,120
750,False,64,65,19,1,18
751,False,81,82,36,0,36
752,False,99,100,35,3,32
753,False,28,29,16,0,16
754,False,34,35,19,0,19
755,False,37,38,23,0,23
756,False,40,41,30,0,30
757,False,56,57,44,0,44
758,False,27,28,49,0,49
759,False,67,68,57,1,56
760,False,29,30,93,0,93
761,False,38,39,38,0,38
762,False,63,64,20,0,20
763,False,27,28,33,1,32
764,False,28,29,20,0,20
765,False,84,85,56,1,55
766,False,22,23,37,1,36
767,False,17,18,9,0,9
768,False,46,47,70,0,70
769,False,32,33,20,0,20
770,False,57,58,82,4,78
771,False,53,54,55,0,55
772,False,16,17,3,0,3
773,False,257,258,96,22,74
774,False,51,52,51,0,51
775,False,87,88,67,0,67
776,False,411,412,255,3,252
777,False,41,42,25,0,25
778,False,66,67,49,1,48
779,False,18,19,30,0,30
780,False,30,31,44,0,44
781,False,39,40,21,0,21
782,False,98,99,83,3,80
783,False,26,27,31,0,31
784,False,45,46,29,0,29
785,False,53,54,32,1,31
786,False,27,28,22,0,22
787,False,80,81,117,0,117
788,False,99,100,88,7,81
789,False,34,35,43,1,42
790,False,29,30,16,0,16
791,False,173,174,134,0,134
792,False,37,38,89,2,87
793,True,792,500,772,28,744
794,False,48,49,47,0,47
795,False,87,88,18,0,18
796,False,82,83,64,1,63
797,False,56,57,35,0,35
798,False,48,49,43,0,43
799,False,52,53,44,0,44
800,False,22,23,29,0,29
801,False,18,19,25,1,24
802,False,79,80,66,0,66
803,False,96,97,121,1,120
804,False,73,74,101,4,97
805,False,50,51,36,0,36
806,False,71,72,62,1,61
807,False,163,164,92,2,90
808,False,34,35,59,1,58
809,False,28,29,12,0,12
810,False,19,20,30,0,30
811,False,51,52,42,0,42
812,False,30,31,15,1,14
813,False,19,20,31,10,21
814,False,42,43,52,0,52
815,False,24,25,17,0,17
816,False,15,16,8,1,7
817,False,46,47,27,0,27
818,False,415,416,251,2,249
819,False,143,144,99,2,97
820,True,873,500,792,5,787
821,False,77,78,80,4,76
822,False,234,235,144,1,143
823,False,19,20,20,1,19
824,False,11,12,5,0,5
825,False,3,4,0,0,0
826,False,12,13,7,0,7
827,False,45,46,61,2,59
828,False,141,142,74,0,74
829,False,17,18,8,1,7
830,False,23,24,12,0,12
831,False,9,10,27,0,27
832,False,31,32,21,0,21
833,False,167,168,111,2,109
834,False,48,49,57,0,57
835,False,56,57,69,0,69
836,False,411,412,239,4,235
837,False,45,46,45,0,45
838,False,17,18,10,0,10
839,False,26,27,33,0,33
840,False,155,156,108,0,108
841,False,59,60,29,0,29
842,False,40,41,29,1,28
843,False,36,37,19,1,18
844,False,91,92,60,0,60
845,False,77,78,38,0,38
846,False,238,239,172,0,172
847,False,45,46,34,0,34
848,False,43,44,24,0,24
849,False,52,53,76,2,74
850,False,38,39,28,0,28
851,False,31,32,55,2,53
852,False,33,34,62,0,62
853,False,20,21,12,0,12
854,False,42,43,94,1,93
855,False,394,395,244,1,243
856,False,47,48,47,0,47
857,False,81,82,55,1,54
858,False,11,12,3,0,3
859,False,76,77,50,3,47
860,False,56,57,18,5,13
861,False,41,42,22,0,22
862,False,14,15,8,0,8
863,False,15,16,14,0,14
864,True,2272,500,1898,27,1871
865,False,219,220,182,2,180
866,False,20,21,5,0,5
867,False,108,109,85,0,85
868,False,75,76,50,0,50
869,False,37,38,10,1,9
870,False,37,38,57,1,56
871,False,122,123,88,1,87
872,False,42,43,18,0,18
873,True,577,500,495,2,493
874,False,35,36,48,0,48
875,False,112,113,123,3,120
876,False,62,63,28,1,27
877,False,50,51,23,0,23
878,False,24,25,41,0,41
879,False,41,42,38,0,38
880,False,10,11,6,0,6
881,False,330,331,279,1,278
882,False,60,61,26,0,26
883,False,56,57,42,0,42
884,False,59,60,25,0,25
885,False,4,5,1,0,1
886,False,2,3,0,0,0
887,False,35,36,14,0,14
888,False,19,20,4,0,4
889,False,18,19,10,0,10
890,False,79,80,59,0,59
891,False,54,55,19,0,19
892,False,66,67,41,0,41
893,False,45,46,19,0,19
894,False,95,96,53,0,53
895,False,69,70,83,0,83
896,False,34,35,87,0,87
897,False,40,41,83,1,82
898,False,8,9,1,0,1
899,False,21,22,8,0,8
900,False,42,43,39,0,39
901,False,34,35,44,0,44
902,False,69,70,53,0,53
903,False,62,63,84,6,78
904,False,17,18,4,0,4
905,False,28,29,41,0,41
906,False,19,20,9,0,9
907,False,56,57,47,0,47
908,False,102,103,71,1,70
909,False,96,97,61,1,60
910,False,320,321,206,0,206
911,False,82,83,43,0,43
912,False,137,138,55,0,55
913,False,63,64,35,1,34
914,False,34,35,20,0,20
915,False,22,23,12,0,12
916,False,10,11,2,1,1
917,False,21,22,34,0,34
918,False,39,40,17,0,17
919,False,142,143,127,1,126
920,False,85,86,53,0,53
921,False,51,52,19,1,18
922,False,48,49,27,0,27
923,False,90,91,56,3,53
924,False,11,12,23,0,23
925,False,13,14,36,2,34
926,False,290,291,351,15,336
927,False,16,17,11,1,10
928,False,182,183,128,5,123
929,False,50,51,34,0,34
930,False,374,375,322,1,321
931,False,219,220,162,0,162
932,False,21,22,13,0,13
933,False,401,402,271,1,270
934,False,67,68,68,0,68
935,False,15,16,16,0,16
936,False,16,17,24,0,24
937,False,75,76,50,0,50
938,False,63,64,37,0,37
939,False,198,199,47,9,38
940,False,55,56,14,0,14
941,False,121,122,59,6,53
942,False,113,114,81,7,74
943,False,71,72,53,0,53
944,False,84,85,44,1,43
945,False,38,39,30,0,30
946,False,231,232,125,2,123
947,False,157,158,77,0,77
948,False,9,10,25,19,6
949,False,12,13,3,0,3
950,False,86,87,45,0,45
951,False,66,67,60,0,60
952,False,88,89,66,0,66
953,False,63,64,34,0,34
954,False,42,43,65,0,65
955,False,46,47,21,0,21
956,False,118,119,119,0,119
957,False,135,136,89,0,89
958,False,35,36,44,0,44
959,False,23,24,40,0,40
960,False,98,99,49,2,47
961,False,54,55,29,0,29
962,False,70,71,49,7,42
963,False,66,67,74,0,74
964,False,11,12,26,1,25
965,False,15,16,8,0,8
966,False,15,16,12,3,9
967,False,39,40,43,0,43
968,False,68,69,59,0,59
969,False,282,283,201,2,199
970,False,87,88,17,0,17
971,False,118,119,41,2,39
972,False,37,38,74,2,72
973,False,66,67,53,3,50
974,False,40,41,70,2,68
975,False,33,34,70,3,67
976,False,12,13,6,0,6
977,False,113,114,82,1,81
978,False,17,18,53,2,51
979,False,15,16,65,1,64
980,False,57,58,76,1,75
981,False,33,34,75,1,74
982,False,47,48,42,6,36
983,False,35,36,28,0,28
984,False,157,158,108,9,99
985,False,97,98,111,0,111
986,False,41,42,42,0,42
987,True,698,500,341,7,334
988,False,8,9,31,0,31
989,False,18,19,14,1,13
990,False,121,122,62,0,62
991,False,42,43,26,0,26
992,True,668,500,517,9,508
993,False,21,22,33,0,33
994,False,114,115,59,1,58
995,False,170,171,123,0,123
996,False,63,64,22,1,21
997,False,16,17,15,0,15
998,False,13,14,1,0,1
999,False,84,85,57,0,57
1000,False,38,39,19,0,19
1001,False,193,194,125,1,124
1002,False,48,49,72,0,72
1003,False,18,19,55,0,55
1004,True,587,500,382,1,381
1005,False,39,40,57,0,57
1006,False,42,43,26,0,26
1007,False,17,18,11,0,11
1008,False,17,18,5,1,4
1009,False,22,23,21,0,21
1010,False,16,17,41,1,40
1011,False,62,63,68,6,62
1012,False,61,62,41,8,33
1013,False,29,30,13,1,12
1014,False,50,51,31,1,30
1015,False,94,95,44,1,43
1016,False,151,152,117,1,116
1017,False,26,27,20,1,19
1018,False,26,27,18,0,18
1019,False,244,245,140,0,140
1020,False,100,101,127,3,124
1021,False,243,244,237,0,237
1022,False,27,28,45,1,44
1023,False,61,62,28,0,28
1024,False,127,128,73,1,72
1025,False,40,41,26,1,25
1026,False,34,35,15,0,15
1027,False,98,99,80,0,80
1028,False,22,23,58,2,56
1029,False,99,100,99,2,97
1030,False,37,38,48,2,46
1031,False,30,31,61,0,61
1032,False,20,21,27,0,27
1033,False,171,172,106,0,106
1034,False,35,36,37,0,37
1035,False,17,18,10,3,7
1036,False,12,13,3,0,3
1037,False,37,38,21,0,21
1038,False,86,87,44,0,44
1039,False,15,16,6,0,6
1040,False,16,17,10,0,10
1041,False,139,140,85,2,83
1042,False,125,126,66,3,63
1043,False,63,64,27,0,27
1044,False,122,123,35,3,32
1045,False,13,14,37,1,36
1046,False,442,443,422,1,421
1047,False,47,48,40,0,40
1048,True,602,500,347,14,333
1049,False,53,54,85,1,84
1050,False,99,100,37,0,37
1051,False,169,170,108,2,106
1052,False,10,11,29,0,29
1053,False,5,6,4,0,4
1054,False,17,18,39,0,39
1055,False,38,39,46,0,46
1056,False,32,33,12,0,12
1057,False,38,39,11,0,11
1058,False,52,53,10,0,10
1059,False,197,198,103,21,82
1060,False,51,52,32,0,32
1061,False,117,118,49,0,49
1062,False,339,340,242,0,242
1063,False,103,104,93,0,93
1064,False,391,392,286,1,285
1065,False,37,38,29,0,29
1066,False,42,43,20,1,19
1067,False,25,26,27,1,26
1068,False,5,6,4,0,4
1069,False,50,51,51,0,51
1070,False,39,40,36,0,36
1071,False,48,49,37,0,37
1072,False,66,67,86,2,84
1073,False,174,175,125,1,124
1074,False,44,45,26,0,26
1075,False,45,46,0,0,0
1076,False,15,16,0,0,0
1077,False,95,96,59,0,59
1078,False,29,30,14,1,13
1079,False,43,44,58,3,55
1080,False,38,39,53,1,52
1081,False,76,77,81,2,79
1082,True,861,500,670,6,664
1083,False,93,94,47,1,46
1084,False,47,48,26,4,22
1085,False,235,236,73,2,71
1086,False,42,43,8,0,8
1087,False,54,55,66,1,65
1088,False,26,27,19,0,19
1089,False,62,63,97,4,93
1090,False,73,74,63,0,63
1091,False,20,21,15,1,14
1092,False,26,27,34,0,34
1093,False,82,83,30,2,28
1094,False,21,22,10,0,10
1095,False,24,25,24,1,23
1096,False,50,51,18,0,18
1097,False,78,79,48,1,47
1098,False,41,42,35,0,35
1099,False,39,40,21,0,21
1100,True,802,500,544,5,539
1101,False,53,54,53,0,53
1102,False,44,45,50,1,49
1103,False,29,30,19,1,18
1104,False,33,34,51,1,50
1105,False,29,30,17,0,17
1106,False,68,69,36,1,35
1107,False,67,68,26,0,26
1108,False,41,42,83,0,83
1109,False,42,43,27,0,27
1110,False,43,44,92,0,92
1111,False,38,39,61,0,61
1112,False,11,12,3,0,3
1113,False,15,16,29,11,18
1114,False,35,36,40,0,40
1115,False,63,64,51,0,51
1116,False,45,46,34,0,34
1117,False,47,48,20,0,20
1118,False,11,12,46,0,46
1119,False,53,54,4,0,4
1120,False,11,12,0,0,0
1121,False,43,44,43,0,43
1122,False,13,14,10,0,10
1123,True,560,500,380,5,375
1124,False,33,34,25,0,25
1125,False,10,11,32,0,32
1126,True,738,500,573,7,566
1127,False,47,48,23,0,23
1128,False,188,189,155,0,155
1129,False,492,493,340,2,338
1130,False,32,33,64,1,63
1131,False,55,56,38,0,38
1132,False,203,204,146,1,145
1133,False,16,17,18,0,18
1134,False,44,45,35,0,35
1135,False,12,13,12,0,12
1136,False,9,10,1,0,1
1137,False,28,29,17,0,17
1138,False,29,30,18,0,18
1139,False,219,220,151,1,150
1140,False,47,48,41,1,40
1141,False,14,15,23,0,23
1142,False,25,26,18,0,18
1143,False,15,16,13,0,13
1144,False,39,40,50,1,49
1145,False,58,59,39,2,37
1146,False,140,141,60,8,52
1147,False,55,56,66,5,61
1148,False,21,22,14,0,14
1149,False,146,147,146,0,146
1150,False,210,211,145,1,144
1151,False,46,47,8,1,7
1152,False,59,60,25,0,25
1153,False,10,11,6,0,6
1154,False,12,13,27,0,27
1155,False,13,14,73,1,72
1156,False,111,112,50,1,49
1157,False,116,117,53,1,52
1158,False,14,15,27,9,18
1159,False,53,54,38,1,37
1160,False,18,19,7,0,7
1161,False,61,62,49,2,47
1162,False,17,18,50,7,43
1163,False,43,44,63,3,60
1164,False,75,76,34,0,34
1165,False,406,407,214,2,212
1166,False,316,317,219,6,213
1167,False,3,4,26,0,26
1168,False,24,25,7,0,7
1169,False,10,11,3,0,3
1170,False,34,35,19,0,19
1171,False,9,10,3,2,1
1172,False,44,45,23,0,23
1173,False,120,121,49,0,49
1174,False,19,20,9,0,9
1175,False,69,70,130,2,128
1176,False,112,113,73,0,73
1177,False,25,26,37,0,37
1178,False,54,55,47,1,46
1179,False,491,492,526,8,518
1180,False,21,22,15,0,15
1181,False,121,122,43,0,43
1182,False,59,60,52,0,52
1183,False,61,62,67,0,67
1184,False,19,20,32,0,32
1185,False,23,24,13,0,13
1186,False,39,40,24,1,23
1187,False,22,23,14,0,14
1188,False,12,13,6,0,6
1189,False,68,69,61,0,61
1190,False,42,43,25,0,25
1191,False,106,107,86,0,86
1192,False,43,44,31,0,31
1193,False,15,16,14,0,14
1194,False,348,349,328,5,323
1195,False,123,124,83,0,83
1196,False,59,60,112,2,110
1197,False,132,133,91,0,91
1198,False,110,111,85,0,85
1199,False,49,50,19,0,19
1200,False,110,111,69,2,67
1201,False,59,60,56,2,54
1202,False,23,24,18,0,18
1203,False,139,140,63,1,62
1204,False,29,30,21,0,21
1205,False,38,39,46,1,45
1206,False,8,9,6,0,6
1207,False,33,34,28,0,28
1208,False,28,29,30,1,29
1209,False,69,70,42,1,41
1210,False,54,55,82,4,78
1211,False,31,32,13,0,13
1212,False,54,55,29,1,28
1213,False,443,444,318,4,314
1214,False,52,53,24,1,23
1215,False,55,56,49,1,48
1216,False,17,18,7,0,7
1217,False,30,31,11,0,11
1218,False,21,22,66,1,65
1219,False,2,3,9,1,8
1220,False,64,65,105,1,104
1221,False,15,16,16,0,16
1222,False,19,20,11,0,11
1223,False,48,49,25,0,25
1224,False,71,72,50,1,49
1225,False,58,59,54,0,54
1226,False,32,33,103,0,103
1227,False,24,25,30,0,30
1228,False,11,12,31,2,29
1229,False,21,22,24,1,23
1230,False,32,33,31,0,31
1231,False,55,56,41,1,40
1232,False,84,85,57,2,55
1233,False,49,50,84,0,84
1234,False,117,118,66,0,66
1235,False,28,29,12,1,11
1236,False,151,152,136,1,135
1237,False,16,17,8,0,8
1238,False,24,25,27,0,27
1239,False,57,58,42,0,42
1240,False,33,34,37,0,37
1241,False,23,24,39,1,38
1242,False,174,175,36,0,36
1243,False,86,87,41,0,41
1244,False,78,79,43,2,41
1245,False,65,66,34,1,33
1246,False,69,70,23,1,22
1247,False,304,305,162,7,155
1248,False,41,42,50,0,50
1249,False,28,29,16,0,16
1250,False,122,123,56,0,56
1251,False,29,30,23,1,22
1252,False,292,293,217,1,216
1253,False,33,34,22,0,22
1254,False,37,38,79,0,79
1255,False,154,155,113,0,113
1256,False,18,19,16,0,16
1257,False,39,40,22,0,22
1258,False,38,39,12,0,12
1259,False,51,52,23,0,23
1260,False,50,51,24,0,24
1261,False,103,104,76,0,76
1262,False,296,297,237,2,235
1263,False,47,48,53,0,53
1264,False,61,62,54,0,54
1265,False,29,30,15,0,15
1266,False,66,67,27,0,27
1267,False,36,37,45,1,44
1268,False,40,41,29,0,29
1269,False,36,37,19,0,19
1270,False,49,50,26,0,26
1271,False,7,8,2,0,2
1272,False,33,34,5,2,3
1273,False,417,418,211,3,208
1274,False,32,33,41,0,41
1275,False,7,8,2,0,2
1276,False,21,22,16,0,16
1277,False,71,72,29,1,28
1278,False,162,163,71,1,70
1279,False,116,117,26,2,24
1280,False,172,173,55,1,54
1281,False,31,32,47,0,47
1282,False,127,128,105,0,105
1283,False,18,19,53,0,53
1284,False,32,33,24,0,24
1285,False,81,82,50,0,50
1286,False,35,36,23,1,22
1287,False,119,120,83,0,83
1288,False,43,44,40,0,40
1289,False,68,69,21,0,21
1290,False,58,59,34,1,33
1291,False,9,10,2,1,1
1292,False,59,60,26,0,26
1293,False,47,48,40,0,40
1294,False,33,34,19,0,19
1295,False,51,52,63,1,62
1296,False,24,25,18,0,18
1297,False,76,77,49,0,49
1298,False,77,78,68,0,68
1299,False,37,38,20,1,19
1300,False,32,33,18,0,18
1301,False,10,11,6,0,6
1302,False,389,390,161,4,157
1303,False,119,120,86,0,86
1304,False,259,260,144,1,143
1305,False,65,66,39,0,39
1306,False,338,339,207,0,207
1307,False,30,31,31,1,30
1308,False,19,20,12,0,12
1309,False,42,43,70,3,67
1310,False,47,48,29,1,28
1311,False,7,8,34,0,34
1312,False,19,20,11,0,11
1313,False,46,47,57,0,57
1314,False,41,42,45,0,45
1315,False,191,192,148,1,147
1316,False,431,432,307,6,301
1317,False,53,54,61,0,61
1318,False,12,13,6,0,6
1319,False,24,25,134,3,131
1320,False,62,63,15,4,11
1321,False,76,77,62,11,51
1322,False,41,42,7,3,4
1323,False,243,244,68,17,51
1324,False,86,87,94,0,94
1325,False,80,81,72,1,71
1326,False,18,19,5,0,5
1327,False,62,63,111,2,109
1328,False,42,43,30,0,30
1329,True,739,500,618,5,613
1330,False,57,58,58,3,55
1331,False,63,64,47,0,47
1332,False,206,207,203,2,201
1333,False,48,49,33,1,32
1334,False,14,15,11,0,11
1335,False,1,2,0,0,0
1336,False,33,34,15,0,15
1337,False,57,58,34,0,34
1338,False,46,47,29,0,29
1339,False,49,50,45,0,45
1340,False,25,26,9,1,8
1341,False,81,82,87,0,87
1342,False,222,223,124,0,124
1343,False,53,54,51,0,51
1344,False,42,43,60,0,60
1345,False,8,9,2,0,2
1346,False,64,65,27,1,26
1347,False,56,57,47,0,47
1348,False,12,13,9,0,9
1349,False,20,21,11,0,11
1350,False,34,35,52,0,52
1351,False,35,36,17,0,17
1352,False,68,69,59,0,59
1353,False,25,26,23,0,23
1354,False,75,76,50,0,50
1355,False,44,45,25,0,25
1356,False,3,4,6,0,6
1357,False,41,42,25,0,25
1358,False,38,39,52,0,52
1359,False,159,160,140,0,140
1360,False,7,8,10,0,10
1361,False,25,26,24,0,24
1362,False,67,68,39,0,39
1363,False,276,277,170,1,169
1364,False,47,48,29,0,29
1365,False,1,2,6,0,6
1366,False,95,96,115,0,115
1367,False,33,34,37,0,37
1368,False,62,63,48,0,48
1369,False,65,66,47,0,47
1370,False,59,60,31,0,31
1371,False,32,33,28,0,28
1372,False,29,30,47,0,47
1373,False,17,18,28,1,27
1374,False,7,8,4,1,3
1375,False,20,21,11,0,11
1376,False,414,415,264,3,261
1377,False,50,51,18,0,18
1378,False,164,165,67,7,60
1379,False,6,7,1,0,1
1380,False,65,66,18,2,16
1381,False,30,31,66,1,65
1382,False,28,29,42,0,42
1383,False,38,39,23,0,23
1384,False,8,9,2,0,2
1385,False,28,29,19,0,19
1386,False,68,69,57,0,57
1387,False,34,35,12,0,12
1388,False,20,21,7,0,7
1389,False,53,54,26,3,23
1390,False,42,43,15,0,15
1391,False,184,185,127,1,126
1392,False,53,54,24,0,24
1393,False,7,8,4,1,3
1394,False,11,12,12,0,12
1395,False,15,16,40,0,40
1396,False,65,66,50,0,50
1397,False,31,32,13,0,13
1398,False,17,18,6,0,6
1399,False,35,36,49,0,49
1400,False,107,108,67,0,67
1401,False,122,123,73,0,73
1402,False,24,25,10,1,9
1403,False,20,21,12,3,9
1404,False,25,26,34,0,34
1405,False,28,29,25,0,25
1406,False,56,57,28,0,28
1407,False,405,406,232,1,231
1408,False,12,13,3,0,3
1409,False,7,8,7,1,6
1410,False,24,25,14,0,14
1411,False,39,40,20,0,20
1412,False,120,121,59,0,59
1413,False,14,15,32,0,32
1414,False,23,24,10,1,9
1415,False,17,18,5,1,4
1416,False,27,28,14,0,14
1417,False,272,273,163,1,162
1418,False,20,21,46,0,46
1419,False,53,54,79,1,78
1420,False,35,36,24,1,23
1421,False,38,39,42,0,42
1422,False,47,48,52,0,52
1423,False,3,4,33,0,33
1424,False,38,39,27,0,27
1425,False,34,35,66,0,66
1426,False,64,65,60,0,60
1427,False,50,51,27,0,27
1428,False,77,78,54,1,53
1429,False,9,10,3,1,2
1430,False,21,22,25,0,25
1431,False,11,12,13,0,13
1432,False,68,69,75,7,68
1433,False,109,110,79,6,73
1434,False,44,45,21,0,21
1435,False,29,30,15,1,14
1436,False,86,87,82,0,82
1437,False,13,14,52,1,51
1438,False,9,10,2,0,2
1439,False,185,186,186,2,184
1440,False,55,56,12,1,11
1441,False,36,37,47,0,47
1442,False,86,87,54,0,54
1443,False,71,72,50,0,50
1444,False,34,35,37,0,37
1445,False,48,49,29,1,28
1446,False,21,22,32,0,32
1447,False,73,74,108,0,108
1448,False,74,75,24,0,24
1449,False,7,8,11,0,11
1450,False,31,32,35,0,35
1451,False,60,61,29,2,27
1452,False,64,65,56,0,56
1453,False,91,92,79,1,78
1454,False,29,30,72,2,70
1455,False,32,33,57,0,57
1456,False,88,89,25,0,25
1457,False,64,65,51,0,51
1458,False,28,29,13,0,13
1459,False,125,126,112,3,109
1460,False,21,22,13,0,13
1461,False,92,93,80,1,79
1462,False,11,12,3,0,3
1463,False,54,55,12,0,12
1464,False,87,88,27,1,26
1465,False,9,10,4,1,3
1466,False,61,62,61,1,60
1467,False,14,15,52,0,52
1468,False,35,36,12,0,12
1469,False,153,154,109,1,108
1470,False,162,163,91,1,90
1471,False,351,352,187,4,183
1472,False,7,8,11,0,11
1473,False,42,43,42,0,42
1474,False,43,44,46,0,46
1475,False,55,56,118,2,116
1476,False,58,59,26,0,26
1477,False,73,74,61,0,61
1478,False,59,60,32,0,32
1479,False,21,22,36,0,36
1480,False,47,48,23,0,23
1481,False,6,7,3,0,3
1482,False,87,88,99,0,99
1483,False,61,62,45,0,45
1484,False,31,32,49,0,49
1485,False,31,32,8,0,8
1486,False,57,58,100,1,99
1487,False,55,56,68,0,68
1488,False,43,44,35,1,34
1489,False,42,43,28,2,26
1490,False,43,44,27,0,27
1491,False,117,118,105,1,104
1492,False,42,43,13,0,13
1493,False,11,12,11,0,11
1494,False,22,23,6,0,6
1495,False,86,87,63,1,62
1496,False,24,25,12,2,10
1497,False,26,27,10,1,9
1498,False,12,13,35,3,32
1499,False,19,20,55,1,54
1500,False,16,17,7,0,7
1501,False,75,76,54,1,53
1502,False,35,36,20,0,20
1503,False,329,330,223,1,222
1504,False,76,77,101,0,101
1505,False,39,40,26,0,26
1506,False,94,95,68,1,67
1507,False,45,46,61,0,61
1508,False,29,30,40,0,40
1509,False,24,25,29,0,29
1510,False,24,25,20,3,17
1511,False,33,34,18,1,17
1512,False,11,12,10,4,6
1513,False,13,14,13,0,13
1514,False,53,54,37,3,34
1515,False,155,156,92,0,92
1516,False,260,261,76,15,61
1517,False,37,38,10,5,5
1518,False,41,42,29,0,29
1519,False,53,54,60,4,56
1520,False,60,61,100,1,99
1521,False,33,34,37,0,37
1522,False,51,52,40,0,40
1523,False,62,63,63,2,61
1524,False,36,37,13,1,12
1525,False,26,27,69,0,69
1526,False,23,24,38,0,38
1527,False,37,38,37,0,37
1528,False,10,11,9,0,9
1529,False,14,15,9,0,9
1530,False,5,6,5,0,5
1531,False,35,36,43,3,40
1532,False,82,83,36,0,36
1533,False,40,41,48,1,47
1534,False,75,76,72,1,71
1535,False,59,60,41,0,41
1536,False,23,24,84,0,84
1537,False,125,126,133,10,123
1538,False,139,140,91,0,91
1539,False,65,66,25,1,24
1540,False,17,18,12,0,12
1541,False,53,54,49,1,48
1542,False,69,70,46,0,46
1543,False,61,62,88,1,87
1544,False,37,38,118,1,117
1545,False,43,44,20,0,20
1546,False,10,11,16,0,16
1547,False,20,21,54,0,54
1548,True,516,500,247,7,240
1549,False,64,65,59,3,56
1550,False,26,27,59,4,55
1551,False,48,49,42,0,42
1552,False,29,30,19,0,19
1553,False,127,128,82,1,81
1554,False,25,26,23,0,23
1555,False,3,4,2,0,2
1556,False,19,20,20,0,20
1557,False,11,12,3,1,2
1558,False,19,20,31,0,31
1559,False,78,79,54,0,54
1560,False,29,30,26,0,26
1561,False,44,45,30,0,30
1562,False,12,13,31,1,30
1563,False,10,11,8,0,8
1564,False,120,121,95,0,95
1565,False,47,48,66,0,66
1566,False,32,33,41,0,41
1567,False,62,63,50,0,50
1568,False,340,341,365,4,361
1569,False,28,29,69,0,69
1570,False,47,48,69,7,62
1571,False,40,41,26,0,26
1572,False,5,6,2,0,2
1573,False,27,28,13,0,13
1574,False,12,13,4,0,4
1575,False,21,22,11,0,11
1576,False,17,18,28,0,28
1577,False,36,37,60,1,59
1578,False,55,56,47,1,46
1579,False,54,55,36,0,36
1580,False,29,30,32,0,32
1581,False,27,28,17,0,17
1582,False,66,67,81,1,80
1583,False,45,46,37,1,36
1584,False,16,17,16,0,16
1585,False,10,11,32,0,32
1586,False,4,5,8,0,8
1587,False,187,188,130,2,128
1588,False,8,9,6,0,6
1589,False,197,198,50,10,40
1590,False,28,29,20,0,20
1591,False,37,38,33,0,33
1592,False,38,39,49,2,47
1593,False,70,71,46,4,42
1594,False,34,35,17,0,17
1595,False,9,10,23,2,21
1596,False,34,35,79,0,79
1597,False,39,40,22,1,21
1598,False,91,92,69,1,68
1599,False,80,81,41,0,41
1600,False,73,74,77,0,77
1601,False,37,38,47,0,47
1602,False,50,51,53,1,52
1603,False,6,7,4,0,4
1604,False,26,27,20,0,20
1605,False,34,35,17,0,17
1606,False,47,48,59,0,59
1607,False,34,35,13,0,13
1608,False,53,54,37,0,37
1609,False,60,61,51,0,51
1610,False,95,96,36,0,36
1611,False,42,43,59,1,58
1612,False,67,68,51,0,51
1613,False,40,41,27,0,27
1614,False,75,76,50,0,50
1615,False,50,51,17,0,17
1616,False,30,31,19,0,19
1617,False,101,102,39,0,39
1618,False,26,27,35,0,35
1619,False,27,28,29,0,29
1620,False,39,40,29,0,29
1621,False,68,69,36,8,28
1622,False,67,68,62,2,60
1623,False,46,47,43,1,42
1624,False,59,60,46,1,45
1625,False,5,6,2,0,2
1626,False,77,78,67,9,58
1627,False,56,57,43,5,38
1628,False,89,90,21,1,20
1629,False,19,20,14,0,14
1630,False,17,18,5,0,5
1631,False,62,63,53,0,53
1632,False,23,24,15,0,15
1633,False,29,30,22,0,22
1634,False,13,14,19,0,19
1635,False,52,53,59,1,58
1636,False,31,32,10,0,10
1637,False,9,10,14,0,14
1638,False,38,39,25,0,25
1639,False,19,20,62,0,62
1640,False,89,90,55,1,54
1641,False,48,49,20,0,20
1642,False,16,17,35,0,35
1643,False,104,105,60,3,57
1644,False,131,132,130,0,130
1645,False,43,44,111,3,108
1646,False,21,22,7,0,7
1647,False,28,29,44,3,41
1648,False,113,114,64,4,60
1649,False,22,23,40,0,40
1650,False,11,12,10,0,10
1651,False,40,41,39,0,39
1652,False,28,29,31,0,31
1653,False,44,45,29,1,28
1654,False,231,232,208,1,207
1655,False,47,48,27,1,26
1656,False,363,364,223,0,223
1657,False,46,47,41,1,40
1658,False,29,30,18,0,18
1659,False,46,47,65,1,64
1660,False,47,48,43,0,43
1661,False,77,78,91,1,90
1662,False,76,77,63,1,62
1663,False,72,73,47,1,46
1664,False,156,157,104,1,103
1665,False,155,156,75,0,75
1666,False,35,36,25,0,25
1667,False,317,318,286,1,285
1668,False,10,11,5,0,5
1669,False,27,28,16,0,16
1670,False,76,77,65,0,65
1671,False,30,31,31,0,31
1672,False,58,59,78,0,78
1673,False,22,23,22,0,22
1674,False,79,80,100,0,100
1675,False,36,37,28,1,27
1676,False,66,67,62,0,62
1677,False,7,8,7,0,7
1678,False,118,119,36,3,33
1679,False,20,21,33,0,33
1680,False,28,29,59,2,57
1681,False,31,32,49,1,48
1682,False,81,82,44,0,44
1683,False,11,12,4,1,3
1684,False,471,472,278,5,273
1685,False,31,32,15,1,14
1686,False,68,69,32,0,32
1687,False,151,152,161,5,156
1688,False,60,61,44,4,40
1689,False,46,47,18,0,18
1690,False,18,19,27,6,21
1691,False,25,26,18,0,18
1692,False,5,6,5,0,5
1693,False,73,74,54,8,46
1694,False,52,53,95,1,94
1695,False,54,55,24,0,24
1696,False,88,89,173,7,166
1697,False,113,114,85,3,82
1698,False,41,42,127,0,127
1699,False,27,28,15,0,15
1700,False,24,25,51,0,51
1701,False,72,73,61,0,61
1702,False,27,28,26,1,25
1703,False,24,25,11,0,11
1704,False,88,89,61,0,61
1705,False,60,61,21,0,21
1706,False,115,116,71,1,70
1707,False,199,200,124,0,124
1708,False,60,61,75,1,74
1709,False,61,62,33,0,33
1710,False,8,9,1,0,1
1711,False,67,68,77,1,76
1712,False,56,57,26,0,26
1713,False,17,18,16,4,12
1714,False,22,23,32,0,32
1715,False,57,58,37,1,36
1716,False,65,66,44,0,44
1717,False,56,57,27,0,27
1718,False,21,22,7,1,6
1719,False,57,58,69,1,68
1720,False,324,325,201,5,196
1721,False,43,44,39,0,39
1722,False,53,54,32,0,32
1723,False,19,20,32,0,32
1724,False,22,23,14,0,14
1725,False,11,12,38,2,36
1726,False,60,61,69,1,68
1727,False,10,11,5,0,5
1728,False,13,14,34,1,33
1729,False,28,29,57,0,57
1730,False,31,32,9,0,9
1731,False,64,65,77,1,76
1732,False,237,238,198,0,198
1733,False,43,44,20,1,19
1734,False,21,22,11,0,11
1735,False,24,25,23,0,23
1736,False,22,23,33,0,33
1737,False,39,40,23,0,23
1738,False,55,56,53,0,53
1739,False,82,83,40,1,39
1740,False,83,84,47,1,46
1741,False,10,11,19,0,19
1742,False,27,28,35,1,34
1743,False,47,48,26,0,26
1744,False,66,67,94,1,93
1745,False,102,103,47,1,46
1746,False,40,41,28,0,28
1747,False,76,77,39,1,38
1748,False,44,45,1,0,1
1749,False,17,18,0,0,0
1750,False,11,12,3,0,3
1751,False,25,26,22,1,21
1752,False,13,14,60,3,57
1753,False,13,14,8,0,8
1754,False,47,48,46,0,46
1755,False,114,115,92,0,92
1756,False,165,166,103,3,100
1757,False,50,51,40,0,40
1758,False,363,364,104,4,100
1759,False,46,47,33,0,33
1760,False,13,14,5,3,2
1761,False,376,377,281,3,278
1762,False,38,39,48,0,48
1763,False,51,52,21,0,21
1764,False,34,35,24,0,24
1765,False,10,11,7,0,7
1766,False,23,24,13,1,12
1767,False,14,15,12,0,12
1768,False,57,58,36,1,35
1769,False,20,21,87,7,80
1770,False,126,127,168,7,161
1771,False,53,54,36,0,36
1772,False,23,24,60,1,59
1773,False,383,384,308,3,305
1774,False,46,47,22,0,22
1775,False,67,68,75,5,70
1776,False,101,102,95,0,95
1777,False,63,64,75,1,74
1778,False,10,11,5,0,5
1779,False,91,92,71,1,70
1780,False,39,40,62,0,62
1781,False,25,26,13,0,13
1782,False,31,32,36,0,36
1783,False,36,37,28,0,28
1784,False,10,11,15,0,15
1785,False,39,40,80,0,80
1786,False,36,37,18,0,18
1787,False,82,83,79,1,78
1788,False,91,92,62,0,62
1789,False,21,22,8,0,8
1790,False,8,9,2,0,2
1791,False,4,5,2,0,2
1792,False,15,16,2,0,2
1793,False,24,25,10,0,10
1794,False,81,82,87,0,87
1795,False,38,39,29,0,29
1796,False,202,203,164,0,164
1797,False,38,39,31,0,31
1798,False,64,65,33,1,32
1799,False,10,11,5,0,5
1800,False,44,45,27,0,27
1801,False,33,34,15,0,15
1802,False,147,148,107,1,106
1803,False,21,22,30,0,30
1804,False,206,207,143,0,143
1805,False,36,37,46,1,45
1806,False,16,17,0,0,0
1807,False,41,42,34,1,33
1808,False,203,204,171,2,169
1809,False,38,39,69,0,69
1810,False,157,158,147,0,147
1811,False,6,7,3,0,3
1812,False,32,33,12,0,12
1813,False,12,13,7,0,7
1814,False,22,23,36,1,35
1815,False,17,18,13,0,13
1816,False,77,78,56,0,56
1817,False,73,74,66,1,65
1818,False,14,15,14,0,14
1819,False,20,21,52,0,52
1820,False,27,28,9,0,9
1821,False,62,63,37,0,37
1822,False,17,18,22,0,22
1823,False,98,99,109,2,107
1824,False,30,31,32,0,32
1825,False,60,61,29,0,29
1826,False,21,22,29,2,27
1827,False,10,11,5,0,5
1828,False,33,34,4,0,4
1829,False,104,105,55,1,54
1830,False,23,24,16,0,16
1831,False,76,77,36,0,36
1832,False,104,105,37,0,37
1833,False,79,80,46,0,46
1834,False,24,25,34,1,33
1835,False,41,42,22,1,21
1836,False,306,307,130,2,128
1837,False,73,74,57,0,57
1838,False,76,77,36,0,36
1839,False,42,43,82,1,81
1840,False,44,45,45,0,45
1841,False,9,10,16,0,16
1842,False,130,131,67,1,66
1843,False,26,27,7,0,7
1844,False,22,23,14,1,13
1845,False,51,52,61,0,61
1846,False,6,7,7,0,7
1847,False,106,107,13,1,12
1848,False,95,96,67,1,66
1849,False,65,66,59,8,51
1850,False,68,69,63,0,63
1851,False,15,16,8,0,8
1852,False,14,15,32,0,32
1853,False,21,22,20,0,20
1854,False,13,14,15,1,14
1855,False,41,42,52,3,49
1856,False,45,46,28,0,28
1857,False,29,30,14,0,14
1858,False,17,18,10,0,10
1859,False,127,128,147,0,147
1860,False,8,9,1,0,1
1861,False,28,29,13,0,13
1862,False,17,18,9,1,8
1863,False,48,49,59,2,57
1864,False,40,41,16,1,15
1865,False,63,64,54,2,52
1866,False,97,98,46,0,46
1867,False,23,24,38,0,38
1868,False,20,21,21,0,21
1869,False,32,33,48,0,48
1870,False,40,41,19,1,18
1871,False,34,35,21,0,21
1872,False,35,36,40,0,40
1873,False,42,43,62,1,61
1874,False,52,53,52,3,49
1875,False,18,19,27,1,26
1876,False,70,71,74,2,72
1877,False,26,27,41,0,41
1878,False,53,54,77,0,77
1879,False,95,96,76,2,74
1880,False,25,26,27,0,27
1881,False,35,36,26,0,26
1882,False,71,72,131,3,128
1883,False,390,391,285,2,283
1884,False,19,20,24,2,22
1885,False,16,17,12,0,12
1886,False,28,29,11,0,11
1887,False,119,120,77,1,76
1888,False,16,17,4,0,4
1889,False,76,77,39,0,39
1890,False,47,48,49,0,49
1891,False,8,9,3,0,3
1892,False,36,37,37,0,37
1893,False,42,43,12,0,12
1894,False,53,54,38,0,38
1895,False,64,65,91,0,91
1896,False,37,38,38,0,38
1897,False,18,19,52,1,51
1898,False,47,48,15,0,15
1899,False,46,47,37,0,37
1900,False,52,53,16,2,14
1901,False,26,27,14,0,14
1902,False,85,86,74,0,74
1903,False,17,18,60,3,57
1904,False,15,16,17,0,17
1905,False,22,23,95,0,95
1906,False,35,36,41,0,41
1907,False,38,39,40,0,40
1908,False,42,43,69,1,68
1909,False,93,94,83,0,83
1910,False,32,33,89,1,88
1911,False,37,38,21,0,21
1912,False,99,100,107,1,106
1913,False,46,47,31,0,31
1914,False,91,92,55,14,41
1915,False,60,61,16,0,16
1916,False,109,110,38,0,38
1917,False,36,37,44,0,44
1918,False,79,80,52,1,51
1919,False,245,246,183,1,182
1920,False,27,28,20,1,19
1921,False,16,17,13,2,11
1922,False,72,73,64,0,64
1923,False,273,274,159,3,156
1924,False,58,59,36,0,36
1925,False,94,95,42,2,40
1926,False,31,32,24,0,24
1927,False,90,91,132,6,126
1928,False,5,6,2,1,1
1929,False,16,17,40,3,37
1930,True,568,500,498,23,475
1931,False,221,222,81,20,61
1932,False,45,46,38,9,29
1933,False,87,88,66,0,66
1934,False,28,29,18,0,18
1935,False,56,57,32,0,32
1936,True,524,500,301,9,292
1937,False,26,27,14,0,14
1938,False,333,334,265,3,262
1939,False,79,80,50,0,50
1940,False,138,139,107,0,107
1941,False,86,87,18,0,18
1942,False,138,139,41,2,39
1943,False,4,5,35,0,35
1944,False,66,67,39,0,39
1945,False,56,57,88,1,87
1946,False,17,18,7,0,7
1947,False,71,72,50,0,50
1948,False,117,118,134,4,130
1949,False,60,61,39,1,38
1950,False,23,24,10,1,9
1951,False,28,29,41,1,40
1952,False,86,87,85,1,84
1953,False,83,84,47,2,45
1954,False,62,63,44,1,43
1955,False,48,49,77,2,75
1956,False,29,30,43,1,42
1957,False,83,84,55,4,51
1958,False,42,43,88,0,88
1959,False,36,37,29,0,29
1960,False,74,75,63,0,63
1961,False,92,93,45,0,45
1962,False,321,322,223,3,220
1963,False,37,38,51,0,51
1964,False,96,97,37,0,37
1965,False,14,15,3,0,3
1966,False,77,78,51,0,51
1967,False,145,146,122,1,121
1968,False,31,32,15,1,14
1969,False,14,15,30,0,30
1970,False,119,120,49,0,49
1971,False,80,81,50,0,50
1972,False,96,97,88,2,86
1973,False,150,151,92,0,92
1974,False,45,46,27,0,27
1975,False,13,14,16,0,16
1976,False,149,150,102,0,102
1977,False,8,9,10,0,10
1978,False,50,51,77,1,76
1979,False,27,28,12,0,12
1980,False,69,70,59,0,59
1981,False,55,56,16,4,12
1982,False,11,12,21,0,21
1983,False,96,97,46,1,45
1984,False,26,27,9,0,9
1985,False,14,15,4,1,3
1986,False,41,42,21,0,21
1987,False,16,17,5,0,5
1988,False,64,65,18,0,18
1989,False,152,153,90,2,88
1990,False,39,40,100,1,99
1991,False,39,40,51,0,51
1992,False,188,189,156,1,155
1993,False,41,42,18,0,18
1994,False,37,38,16,0,16
1995,False,34,35,16,0,16
1996,False,78,79,45,0,45
1997,False,78,79,35,0,35
1998,False,70,71,52,0,52
1999,False,20,21,13,0,13
2000,False,16,17,8,0,8
2001,False,46,47,26,0,26
2002,False,33,34,18,0,18
2003,False,35,36,26,0,26
2004,False,130,131,136,0,136
2005,False,283,284,169,1,168
2006,False,31,32,15,0,15
2007,False,22,23,16,0,16
2008,False,292,293,228,1,227
2009,False,33,34,106,1,105
2010,False,55,56,74,0,74
2011,False,33,34,18,0,18
2012,False,16,17,12,0,12
2013,False,31,32,43,0,43
2014,False,119,120,110,4,106
2015,False,12,13,101,7,94
2016,False,34,35,31,1,30
2017,False,117,118,95,1,94
2018,False,185,186,153,0,153
2019,False,110,111,95,1,94
2020,False,17,18,45,0,45
2021,False,45,46,54,0,54
2022,False,52,53,28,1,27
2023,False,32,33,10,0,10
2024,False,20,21,68,5,63
2025,False,63,64,45,0,45
2026,False,34,35,20,0,20
2027,False,43,44,29,0,29
2028,False,190,191,49,15,34
2029,False,30,31,38,0,38
2030,False,142,143,70,1,69
2031,False,16,17,5,0,5
2032,False,36,37,12,0,12
2033,False,124,125,78,0,78
2034,False,57,58,17,0,17
2035,False,140,141,139,1,138
2036,False,60,61,40,0,40
2037,False,70,71,44,0,44
2038,False,144,145,95,2,93
2039,False,136,137,109,0,109
2040,False,21,22,17,0,17
2041,False,5,6,1,0,1
2042,False,6,7,7,0,7
2043,False,37,38,13,0,13
2044,False,40,41,44,0,44
2045,False,13,14,4,0,4
2046,False,77,78,66,1,65
2047,False,71,72,53,0,53
2048,False,235,236,205,0,205
2049,False,12,13,26,10,16
2050,False,32,33,36,0,36
2051,False,15,16,39,1,38
2052,False,22,23,32,2,30
2053,False,26,27,7,0,7
2054,False,25,26,9,0,9
2055,False,164,165,106,0,106
2056,False,9,10,6,0,6
2057,False,119,120,82,2,80
2058,False,10,11,2,0,2
2059,False,32,33,45,1,44
2060,False,92,93,47,0,47
2061,False,72,73,21,0,21
2062,False,65,66,69,2,67
2063,False,14,15,11,0,11
2064,False,44,45,30,0,30
2065,False,42,43,57,1,56
2066,False,26,27,20,0,20
2067,False,33,34,10,0,10
2068,False,40,41,53,0,53
2069,False,32,33,13,0,13
2070,False,35,36,39,0,39
2071,False,34,35,22,0,22
2072,False,61,62,59,0,59
2073,False,55,56,32,2,30
2074,False,45,46,20,0,20
2075,False,28,29,7,0,7
2076,False,30,31,64,0,64
2077,False,69,70,22,5,17
2078,False,23,24,11,0,11
2079,False,85,86,63,0,63
2080,False,69,70,49,2,47
2081,False,17,18,28,1,27
2082,False,23,24,34,0,34
2083,False,27,28,8,0,8
2084,False,51,52,38,0,38
2085,False,102,103,87,4,83
2086,False,28,29,38,0,38
2087,False,272,273,91,6,85
2088,False,105,106,54,5,49
2089,False,179,180,56,14,42
2090,False,70,71,83,0,83
2091,False,54,55,45,0,45
2092,False,103,104,36,1,35
2093,False,257,258,190,2,188
2094,False,16,17,29,0,29
2095,False,48,49,27,0,27
2096,False,60,61,78,0,78
2097,False,18,19,6,0,6
2098,False,35,36,16,0,16
2099,False,54,55,29,1,28
2100,False,36,37,57,2,55
2101,False,35,36,15,0,15
2102,False,176,177,133,1,132
2103,False,33,34,21,0,21
2104,False,54,55,25,0,25
2105,False,75,76,51,0,51
2106,False,34,35,33,0,33
2107,False,8,9,4,0,4
2108,False,42,43,45,0,45
2109,False,56,57,59,0,59
2110,False,17,18,6,1,5
2111,False,39,40,36,2,34
2112,False,56,57,67,4,63
2113,False,57,58,23,0,23
2114,False,3,4,0,0,0
2115,False,3,4,0,0,0
2116,False,19,20,3,0,3
2117,False,106,107,76,1,75
2118,False,145,146,91,1,90
2119,False,37,38,25,0,25
2120,False,49,50,83,0,83
2121,False,33,34,49,2,47
2122,False,59,60,38,0,38
2123,False,321,322,252,7,245
2124,False,22,23,14,0,14
2125,False,381,382,257,1,256
2126,False,36,37,26,0,26
2127,False,81,82,46,0,46
2128,False,14,15,8,0,8
2129,False,159,160,93,0,93
2130,False,140,141,105,1,104
2131,False,27,28,38,1,37
2132,False,17,18,26,6,20
2133,False,38,39,51,2,49
2134,False,17,18,15,2,13
2135,False,75,76,80,9,71
2136,False,62,63,39,5,34
2137,False,20,21,25,0,25
2138,False,35,36,16,0,16
2139,False,34,35,13,0,13
2140,False,10,11,12,0,12
2141,False,11,12,1,0,1
2142,False,59,60,36,0,36
2143,False,37,38,12,0,12
2144,False,48,49,60,0,60
2145,False,92,93,38,1,37
2146,False,49,50,38,0,38
2147,False,57,58,43,1,42
2148,False,189,190,100,6,94
2149,False,129,130,113,0,113
2150,False,78,79,50,0,50
2151,False,279,280,169,1,168
2152,False,60,61,55,1,54
2153,False,68,69,30,0,30
2154,False,20,21,31,0,31
2155,False,229,230,133,0,133
2156,False,44,45,41,0,41
2157,False,25,26,41,0,41
2158,False,30,31,63,3,60
2159,False,46,47,26,0,26
2160,False,34,35,18,0,18
2161,False,15,16,67,2,65
2162,False,41,42,37,0,37
2163,False,53,54,26,0,26
2164,False,26,27,73,0,73
2165,False,38,39,32,0,32
2166,False,81,82,87,0,87
2167,False,19,20,14,0,14
2168,False,52,53,29,0,29
2169,False,98,99,59,0,59
2170,False,120,121,66,1,65
2171,False,56,57,17,0,17
2172,False,23,24,8,0,8
2173,False,19,20,5,0,5
2174,False,19,20,13,0,13
2175,False,36,37,46,2,44
2176,False,17,18,31,1,30
2177,False,11,12,2,0,2
2178,False,34,35,23,1,22
2179,False,29,30,37,0,37
2180,False,32,33,7,0,7
2181,False,22,23,14,0,14
2182,False,8,9,4,0,4
2183,False,31,32,10,0,10
2184,False,38,39,21,0,21
2185,False,16,17,6,0,6
2186,False,1,2,0,0,0
2187,False,4,5,3,0,3
2188,False,74,75,38,0,38
2189,False,101,102,56,0,56
2190,False,28,29,73,0,73
2191,False,17,18,13,1,12
2192,False,32,33,63,0,63
2193,False,98,99,66,4,62
2194,False,94,95,38,0,38
2195,False,165,166,84,0,84
2196,False,41,42,44,0,44
2197,False,23,24,59,0,59
2198,False,20,21,40,0,40
2199,False,55,56,47,0,47
2200,False,24,25,6,0,6
2201,False,18,19,2,0,2
2202,False,10,11,3,0,3
2203,False,39,40,50,0,50
2204,False,93,94,48,0,48
2205,False,73,74,20,0,20
2206,False,13,14,3,1,2
2207,False,30,31,26,0,26
2208,False,23,24,18,0,18
2209,False,49,50,29,0,29
2210,False,42,43,39,0,39
2211,False,11,12,9,2,7
2212,False,17,18,12,0,12
2213,False,35,36,78,0,78
2214,False,83,84,127,0,127
2215,False,34,35,54,0,54
2216,False,120,121,83,0,83
2217,False,150,151,135,0,135
2218,False,36,37,56,1,55
2219,False,9,10,11,0,11
2220,False,28,29,19,0,19
2221,False,19,20,12,0,12
2222,False,55,56,126,0,126
2223,False,28,29,24,0,24
2224,False,114,115,71,2,69
2225,False,13,14,11,0,11
2226,False,9,10,10,0,10
2227,False,3,4,2,0,2
2228,False,44,45,29,1,28
2229,False,88,89,61,0,61
2230,False,71,72,45,0,45
2231,False,38,39,38,1,37
2232,False,108,109,24,1,23
2233,False,181,182,59,2,57
2234,False,79,80,98,0,98
2235,False,59,60,39,0,39
2236,False,22,23,81,0,81
2237,False,31,32,49,0,49
2238,False,78,79,64,0,64
2239,False,22,23,40,0,40
2240,False,106,107,78,1,77
2241,False,14,15,7,0,7
2242,False,27,28,15,0,15
2243,False,67,68,49,1,48
2244,False,102,103,70,0,70
2245,False,20,21,39,0,39
2246,False,75,76,66,0,66
2247,False,28,29,52,0,52
2248,False,74,75,25,2,23
2249,False,64,65,18,1,17
2250,False,119,120,83,0,83
2251,False,15,16,26,0,26
2252,False,296,297,204,1,203
2253,False,36,37,46,1,45
2254,False,10,11,3,0,3
2255,False,37,38,43,0,43
2256,False,21,22,54,0,54
2257,False,29,30,20,1,19
2258,False,57,58,43,0,43
2259,False,45,46,21,0,21
2260,False,46,47,52,0,52
2261,False,76,77,49,0,49
2262,False,94,95,72,0,72
2263,False,58,59,28,0,28
2264,False,41,42,39,0,39
2265,False,129,130,91,2,89
2266,False,35,36,17,0,17
2267,False,30,31,38,1,37
2268,False,86,87,29,0,29
2269,False,47,48,30,1,29
2270,False,25,26,40,1,39
2271,False,226,227,237,3,234
2272,False,50,51,25,0,25
2273,False,61,62,68,1,67
2274,False,245,246,179,1,178
2275,False,11,12,0,0,0
2276,False,26,27,25,0,25
2277,False,38,39,26,1,25
2278,False,35,36,33,2,31
2279,False,12,13,9,0,9
2280,False,10,11,6,0,6
2281,False,268,269,269,1,268
2282,False,15,16,25,0,25
2283,False,68,69,29,0,29
2284,False,396,397,250,2,248
2285,False,6,7,5,0,5
2286,False,39,40,27,0,27
2287,False,67,68,50,1,49
2288,False,33,34,41,1,40
2289,False,81,82,107,10,97
2290,False,31,32,33,0,33
2291,False,11,12,10,0,10
2292,False,37,38,9,0,9
2293,False,26,27,29,0,29
2294,False,83,84,56,0,56
2295,False,54,55,82,0,82
2296,False,28,29,61,1,60
2297,False,7,8,2,1,1
2298,False,103,104,53,0,53
2299,False,33,34,32,0,32
2300,False,17,18,28,0,28
2301,False,98,99,97,0,97
2302,False,106,107,67,0,67
2303,False,56,57,36,1,35
2304,False,95,96,91,1,90
2305,False,38,39,27,0,27
2306,False,20,21,55,0,55
2307,False,1,2,1,0,1
2308,False,34,35,30,0,30
2309,False,30,31,16,0,16
2310,False,176,177,180,1,179
2311,False,12,13,38,0,38
2312,False,19,20,23,3,20
2313,False,58,59,26,0,26
2314,False,51,52,13,0,13
2315,False,38,39,40,1,39
2316,False,20,21,34,0,34
2317,False,36,37,52,1,51
2318,False,66,67,65,1,64
2319,False,156,157,152,0,152
2320,False,54,55,45,1,44
2321,False,158,159,123,1,122
2322,False,54,55,63,0,63
2323,False,74,75,26,0,26
2324,False,45,46,53,1,52
2325,False,39,40,17,0,17
2326,False,108,109,99,3,96
2327,False,58,59,39,0,39
2328,False,37,38,8,0,8
2329,False,59,60,46,0,46
2330,False,35,36,43,0,43
2331,False,40,41,20,0,20
2332,False,70,71,38,0,38
2333,False,53,54,56,0,56
2334,False,23,24,56,1,55
2335,False,29,30,24,0,24
2336,False,30,31,14,0,14
2337,False,21,22,10,0,10
2338,False,17,18,31,0,31
2339,False,29,30,27,0,27
2340,False,28,29,16,0,16
2341,False,23,24,29,0,29
2342,False,178,179,74,13,61
2343,False,56,57,49,1,48
2344,False,37,38,57,0,57
2345,False,44,45,30,2,28
2346,False,121,122,75,0,75
2347,False,71,72,40,3,37
2348,False,42,43,21,2,19
2349,False,70,71,54,0,54
2350,False,18,19,12,0,12
2351,False,34,35,30,0,30
2352,False,46,47,36,0,36
2353,False,176,177,111,0,111
2354,False,65,66,62,1,61
2355,False,17,18,36,0,36
2356,False,26,27,11,0,11
2357,False,54,55,28,0,28
2358,False,66,67,38,0,38
2359,False,55,56,46,0,46
2360,False,35,36,31,0,31
2361,False,16,17,8,0,8
2362,False,13,14,9,0,9
2363,False,20,21,14,0,14
2364,False,94,95,70,0,70
2365,False,42,43,35,0,35
2366,False,52,53,38,0,38
2367,False,22,23,19,0,19
2368,False,34,35,79,0,79
2369,False,72,73,55,0,55
2370,False,86,87,95,5,90
2371,False,100,101,54,1,53
2372,False,242,243,183,1,182
2373,False,151,152,144,0,144
2374,False,21,22,14,0,14
2375,False,39,40,22,0,22
2376,False,23,24,10,0,10
2377,False,20,21,18,0,18
2378,False,42,43,20,0,20
2379,False,55,56,76,0,76
2380,False,47,48,24,0,24
2381,False,101,102,116,0,116
2382,False,52,53,29,0,29
2383,False,56,57,38,0,38
2384,False,42,43,64,1,63
2385,False,14,15,13,0,13
2386,False,13,14,4,2,2
2387,False,52,53,20,1,19
2388,False,35,36,45,0,45
2389,False,11,12,33,0,33
2390,False,134,135,121,3,118
2391,False,20,21,31,1,30
2392,False,23,24,42,0,42
2393,False,62,63,60,0,60
2394,False,55,56,24,1,23
2395,False,62,63,52,0,52
2396,False,235,236,141,0,141
2397,False,70,71,18,0,18
2398,False,71,72,28,1,27
2399,False,25,26,39,0,39
2400,False,15,16,7,0,7
2401,False,71,72,38,0,38
2402,False,37,38,17,0,17
2403,False,69,70,51,0,51
2404,False,27,28,17,0,17
2405,False,101,102,60,0,60
2406,False,34,35,18,0,18
2407,False,34,35,22,0,22
2408,False,29,30,25,0,25
2409,False,30,31,59,0,59
2410,False,34,35,88,2,86
2411,False,84,85,49,0,49
2412,False,406,407,251,1,250
2413,False,72,73,61,0,61
2414,False,34,35,39,0,39
2415,False,34,35,41,0,41
2416,False,35,36,33,0,33
2417,False,45,46,31,1,30
2418,False,9,10,4,0,4
2419,False,3,4,1,0,1
2420,False,53,54,71,2,69
2421,False,60,61,30,2,28
2422,False,56,57,39,1,38
2423,False,92,93,84,4,80
2424,False,73,74,83,0,83
2425,False,36,37,41,0,41
2426,False,159,160,96,1,95
2427,False,30,31,10,0,10
2428,False,26,27,7,0,7
2429,False,72,73,59,1,58
2430,False,23,24,19,0,19
2431,False,111,112,71,1,70
2432,False,4,5,0,0,0
2433,False,17,18,6,0,6
2434,False,13,14,9,4,5
2435,False,63,64,93,4,89
2436,False,57,58,25,0,25
2437,False,26,27,21,0,21
2438,False,31,32,24,0,24
2439,False,19,20,14,0,14
2440,False,455,456,473,18,455
2441,False,43,44,19,0,19
2442,False,53,54,30,0,30
2443,False,14,15,24,6,18
2444,False,6,7,1,0,1
2445,False,24,25,13,2,11
2446,False,46,47,60,0,60
2447,False,32,33,22,0,22
2448,False,47,48,72,0,72
2449,False,51,52,40,0,40
2450,False,28,29,14,0,14
2451,False,15,16,30,0,30
2452,False,8,9,4,1,3
2453,False,36,37,44,0,44
2454,False,45,46,118,4,114
2455,False,35,36,26,0,26
2456,False,34,35,40,1,39
2457,False,27,28,10,1,9
2458,False,147,148,109,0,109
2459,False,62,63,101,0,101
2460,False,55,56,45,0,45
2461,False,118,119,72,0,72
2462,False,33,34,33,1,32
2463,False,58,59,43,0,43
2464,False,53,54,5,0,5
2465,False,17,18,0,0,0
2466,False,26,27,13,3,10
2467,False,108,109,39,0,39
2468,False,49,50,49,2,47
2469,False,36,37,25,0,25
2470,False,35,36,16,0,16
2471,False,27,28,28,0,28
2472,False,84,85,64,0,64
2473,False,42,43,22,1,21
2474,False,34,35,45,0,45
2475,False,52,53,24,2,22
2476,False,74,75,45,4,41
2477,False,61,62,45,0,45
2478,False,33,34,17,1,16
2479,False,51,52,55,4,51
2480,False,66,67,43,2,41
2481,False,25,26,32,1,31
2482,False,44,45,50,0,50
2483,False,82,83,44,2,42
2484,False,38,39,69,2,67
2485,False,13,14,11,0,11
2486,False,35,36,14,0,14
2487,False,21,22,20,0,20
2488,False,85,86,45,1,44
2489,False,50,51,32,0,32
2490,False,100,101,45,1,44
2491,False,89,90,30,1,29
2492,False,29,30,57,0,57
2493,False,39,40,76,0,76
2494,False,100,101,98,0,98
2495,False,66,67,53,0,53
2496,False,66,67,70,0,70
2497,False,42,43,86,3,83
2498,False,45,46,51,2,49
2499,False,40,41,62,0,62
2500,False,31,32,39,0,39
2501,False,38,39,53,3,50
2502,False,21,22,15,0,15
2503,False,40,41,53,0,53
2504,False,77,78,50,1,49
2505,False,12,13,7,0,7
2506,False,28,29,38,1,37
2507,False,95,96,71,0,71
2508,False,39,40,59,2,57
2509,False,43,44,33,0,33
2510,False,52,53,37,1,36
2511,False,15,16,7,0,7
2512,False,40,41,21,0,21
2513,False,39,40,11,1,10
2514,False,141,142,80,0,80
2515,False,36,37,57,1,56
2516,False,36,37,40,0,40
2517,False,34,35,13,0,13
2518,False,42,43,45,0,45
2519,False,43,44,38,0,38
2520,False,20,21,15,0,15
2521,False,45,46,14,0,14
2522,False,22,23,39,0,39
2523,False,131,132,92,4,88
2524,False,183,184,134,1,133
2525,False,186,187,62,1,61
2526,False,65,66,63,2,61
2527,False,32,33,29,0,29
2528,False,28,29,24,1,23
2529,False,54,55,52,3,49
2530,False,62,63,57,1,56
2531,False,51,52,71,0,71
2532,False,31,32,24,0,24
2533,False,41,42,37,0,37
2534,False,21,22,7,0,7
2535,False,16,17,36,0,36
2536,False,68,69,60,0,60
2537,False,58,59,55,1,54
2538,False,8,9,28,0,28
2539,False,21,22,11,0,11
2540,False,44,45,35,0,35
2541,False,64,65,39,4,35
2542,False,6,7,5,1,4
2543,False,49,50,26,0,26
2544,False,64,65,56,1,55
2545,False,75,76,51,1,50
2546,False,150,151,73,4,69
2547,False,33,34,28,0,28
2548,False,6,7,4,0,4
2549,False,52,53,29,1,28
2550,False,45,46,38,0,38
2551,False,70,71,67,0,67
2552,False,156,157,111,1,110
2553,False,30,31,19,0,19
2554,False,30,31,22,0,22
2555,False,21,22,19,0,19
2556,False,71,72,73,2,71
2557,False,23,24,6,0,6
2558,False,382,383,163,11,152
2559,False,96,97,67,1,66
2560,False,30,31,47,0,47
2561,False,30,31,36,0,36
2562,False,53,54,49,1,48
2563,False,71,72,76,1,75
2564,False,46,47,56,1,55
2565,False,153,154,101,0,101
2566,False,35,36,33,0,33
2567,False,100,101,81,1,80
2568,False,18,19,0,0,0
2569,False,92,93,43,0,43
2570,False,76,77,71,10,61
2571,False,97,98,51,4,47
2572,False,35,36,61,0,61
2573,False,56,57,72,4,68
2574,False,48,49,20,0,20
2575,False,36,37,28,0,28
2576,False,26,27,9,0,9
2577,False,82,83,86,3,83
2578,False,39,40,26,0,26
2579,False,62,63,57,9,48
2580,False,136,137,123,2,121
2581,False,25,26,22,0,22
2582,False,28,29,14,0,14
2583,False,39,40,36,1,35
2584,False,37,38,14,0,14
2585,False,14,15,26,0,26
2586,False,30,31,11,0,11
2587,False,17,18,7,0,7
2588,False,53,54,57,9,48
2589,False,44,45,29,1,28
2590,False,35,36,35,1,34
2591,False,85,86,62,0,62
2592,False,15,16,18,0,18
2593,False,70,71,66,0,66
2594,False,54,55,62,2,60
2595,False,24,25,9,0,9
2596,False,22,23,108,0,108
2597,False,18,19,31,0,31
2598,False,40,41,62,0,62
2599,False,56,57,32,0,32
2600,False,24,25,37,0,37
2601,False,21,22,21,0,21
2602,False,182,183,159,1,158
2603,False,48,49,24,1,23
2604,False,45,46,70,0,70
2605,False,33,34,36,0,36
2606,False,20,21,31,0,31
2607,False,34,35,20,0,20
2608,False,42,43,47,0,47
2609,False,267,268,259,2,257
2610,False,15,16,12,0,12
2611,False,92,93,69,2,67
2612,False,153,154,88,1,87
2613,False,25,26,8,0,8
2614,False,59,60,50,1,49
2615,False,16,17,6,0,6
2616,False,79,80,66,1,65
2617,False,59,60,44,2,42
2618,False,44,45,18,1,17
2619,False,60,61,30,5,25
2620,False,44,45,38,0,38
2621,False,3,4,1,0,1
2622,False,123,124,121,2,119
2623,False,46,47,16,0,16
2624,False,17,18,10,0,10
2625,False,93,94,46,0,46
2626,False,84,85,61,0,61
2627,False,57,58,32,0,32
2628,False,46,47,45,0,45
2629,False,40,41,58,0,58
2630,False,28,29,9,0,9
2631,False,13,14,5,0,5
2632,False,45,46,27,0,27
2633,False,24,25,16,0,16
2634,False,57,58,42,1,41
2635,False,90,91,37,0,37
2636,False,80,81,84,0,84
2637,False,44,45,64,0,64
2638,False,220,221,154,0,154
2639,False,34,35,14,0,14
2640,False,32,33,32,0,32
2641,False,7,8,2,0,2
2642,False,53,54,17,0,17
2643,False,87,88,33,0,33
2644,False,53,54,51,0,51
2645,False,35,36,28,0,28
2646,False,182,183,50,1,49
2647,False,77,78,26,0,26
2648,False,53,54,43,2,41
2649,False,53,54,53,1,52
2650,False,31,32,28,0,28
2651,False,97,98,52,0,52
2652,False,48,49,36,0,36
2653,False,32,33,21,0,21
2654,False,73,74,90,2,88
2655,False,13,14,36,0,36
2656,False,40,41,54,1,53
2657,False,74,75,50,0,50
2658,False,74,75,98,6,92
2659,False,25,26,24,2,22
2660,False,103,104,66,1,65
2661,False,41,42,46,0,46
2662,False,36,37,11,0,11
2663,False,9,10,3,1,2
2664,False,51,52,45,2,43
2665,False,54,55,43,1,42
2666,False,93,94,65,1,64
2667,False,77,78,53,0,53
2668,False,23,24,29,0,29
2669,False,31,32,19,0,19
2670,False,111,112,91,9,82
2671,False,50,51,60,10,50
2672,False,46,47,55,0,55
2673,False,90,91,72,1,71
2674,False,30,31,22,1,21
2675,False,28,29,28,1,27
2676,False,75,76,28,1,27
2677,False,11,12,22,0,22
2678,False,71,72,57,1,56
2679,False,18,19,7,0,7
2680,False,99,100,40,0,40
2681,False,111,112,55,0,55
2682,False,39,40,24,0,24
2683,False,45,46,73,0,73
2684,False,45,46,44,0,44
2685,False,58,59,48,3,45
2686,False,108,109,74,1,73
2687,False,54,55,37,4,33
2688,False,55,56,43,1,42
2689,False,113,114,111,0,111
2690,False,27,28,15,0,15
2691,False,80,81,43,0,43
2692,False,30,31,41,0,41
2693,False,24,25,37,3,34
2694,False,19,20,6,0,6
2695,False,143,144,96,1,95
2696,False,58,59,65,0,65
2697,False,35,36,44,0,44
2698,False,50,51,32,0,32
2699,False,26,27,54,2,52
2700,False,46,47,50,0,50
2701,False,70,71,32,0,32
2702,False,277,278,82,3,79
2703,False,61,62,60,1,59
2704,False,48,49,50,0,50
2705,False,40,41,38,0,38
2706,False,59,60,33,1,32
2707,False,65,66,47,2,45
2708,False,171,172,181,3,178
2709,False,29,30,16,0,16
2710,False,19,20,8,0,8
2711,False,15,16,5,0,5
2712,False,45,46,19,0,19
2713,False,42,43,14,0,14
2714,False,74,75,17,0,17
2715,False,68,69,24,1,23
2716,False,60,61,69,2,67
2717,False,39,40,41,3,38
2718,False,22,23,15,0,15
2719,False,62,63,37,1,36
2720,False,34,35,16,0,16
2721,False,100,101,65,1,64
2722,False,32,33,31,0,31
2723,False,93,94,96,3,93
2724,False,322,323,189,6,183
2725,False,32,33,43,0,43
2726,False,30,31,34,0,34
2727,False,13,14,28,0,28
2728,False,19,20,31,0,31
2729,False,14,15,17,2,15
2730,False,10,11,27,0,27
2731,False,44,45,30,0,30
2732,False,22,23,18,0,18
2733,False,73,74,55,10,45
2734,False,65,66,64,0,64
2735,False,129,130,82,2,80
2736,False,43,44,13,0,13
2737,False,24,25,73,1,72
2738,False,210,211,173,2,171
2739,False,68,69,152,1,151
2740,False,14,15,37,0,37
2741,False,101,102,57,0,57
2742,False,32,33,86,0,86
2743,False,7,8,69,2,67
2744,False,71,72,75,0,75
2745,False,44,45,41,0,41
2746,False,62,63,42,0,42
2747,False,13,14,33,0,33
2748,False,18,19,30,0,30
2749,False,5,6,28,1,27
2750,False,34,35,32,0,32
2751,False,27,28,14,0,14
2752,False,28,29,11,0,11
2753,False,61,62,34,0,34
2754,False,17,18,15,0,15
2755,False,23,24,20,0,20
2756,False,82,83,61,1,60
2757,False,58,59,25,0,25
2758,False,27,28,10,0,10
2759,False,45,46,60,2,58
2760,False,39,40,26,0,26
2761,False,102,103,88,1,87
2762,False,6,7,3,0,3
2763,False,45,46,35,0,35
2764,False,27,28,26,0,26
2765,False,27,28,24,1,23
2766,False,9,10,3,0,3
2767,False,31,32,16,0,16
2768,False,50,51,63,0,63
2769,False,23,24,10,0,10
2770,False,111,112,91,0,91
2771,False,138,139,56,0,56
2772,False,41,42,21,1,20
2773,False,48,49,53,0,53
2774,False,31,32,80,1,79
2775,False,145,146,98,1,97
2776,False,24,25,84,0,84
2777,False,30,31,53,1,52
2778,False,18,19,19,0,19
2779,False,8,9,2,0,2
2780,False,31,32,16,0,16
2781,False,36,37,37,0,37
2782,False,100,101,58,1,57
2783,False,56,57,34,1,33
2784,False,71,72,53,0,53
2785,False,39,40,24,0,24
2786,False,37,38,35,0,35
2787,False,18,19,27,0,27
2788,False,18,19,7,1,6
2789,False,13,14,2,0,2
2790,False,91,92,70,0,70
2791,False,79,80,36,0,36
2792,False,38,39,17,0,17
2793,False,13,14,6,0,6
2794,False,108,109,86,3,83
2795,False,77,78,85,1,84
2796,False,44,45,11,0,11
2797,False,51,52,37,1,36
2798,False,29,30,38,0,38
2799,False,4,5,5,0,5
2800,False,19,20,21,0,21
2801,False,92,93,79,0,79
2802,False,23,24,12,0,12
2803,False,16,17,9,0,9
2804,False,25,26,26,0,26
2805,False,12,13,4,1,3
2806,False,30,31,17,0,17
2807,False,95,96,48,3,45
2808,False,142,143,110,1,109
2809,False,55,56,36,0,36
2810,False,33,34,74,0,74
2811,False,40,41,40,0,40
2812,False,115,116,113,1,112
2813,False,13,14,5,0,5
2814,False,29,30,61,0,61
2815,False,30,31,17,0,17
2816,False,8,9,1,0,1
2817,False,182,183,124,0,124
2818,False,54,55,51,1,50
2819,False,28,29,40,0,40
2820,False,54,55,25,0,25
2821,False,56,57,53,0,53
2822,False,464,465,346,3,343
2823,False,14,15,7,0,7
2824,False,13,14,39,0,39
2825,False,112,113,63,0,63
2826,False,53,54,59,0,59
2827,False,24,25,20,0,20
2828,False,17,18,3,1,2
2829,False,7,8,3,0,3
2830,False,60,61,59,7,52
2831,False,49,50,82,5,77
2832,False,70,71,53,0,53
2833,False,6,7,2,0,2
2834,False,91,92,49,1,48
2835,False,50,51,58,2,56
2836,False,39,40,19,1,18
2837,False,48,49,24,0,24
2838,False,52,53,29,0,29
2839,False,39,40,17,1,16
2840,False,37,38,29,0,29
2841,False,17,18,16,0,16
2842,False,50,51,81,1,80
2843,False,8,9,4,0,4
2844,False,67,68,43,0,43
2845,False,35,36,21,2,19
2846,False,21,22,27,0,27
2847,False,30,31,14,0,14
2848,False,257,258,262,1,261
2849,False,52,53,62,1,61
2850,False,38,39,18,0,18
2851,False,36,37,25,0,25
2852,False,36,37,61,2,59
2853,False,14,15,8,0,8
2854,False,3,4,2,0,2
2855,False,18,19,11,0,11
2856,False,34,35,84,1,83
2857,False,184,185,130,1,129
2858,False,17,18,5,0,5
2859,False,68,69,39,0,39
2860,False,74,75,33,0,33
2861,False,68,69,47,0,47
2862,False,20,21,30,0,30
2863,False,59,60,31,0,31
2864,False,70,71,45,0,45
2865,False,42,43,13,0,13
2866,False,98,99,55,4,51
2867,False,35,36,42,0,42
2868,False,72,73,17,2,15
2869,False,53,54,25,3,22
2870,False,48,49,18,1,17
2871,False,9,10,17,1,16
2872,False,45,46,23,0,23
2873,False,92,93,76,2,74
2874,False,74,75,65,0,65
2875,False,33,34,43,0,43
2876,False,28,29,13,1,12
2877,False,126,127,69,3,66
2878,False,36,37,43,0,43
2879,False,17,18,73,1,72
2880,False,82,83,60,1,59
2881,False,142,143,102,1,101
2882,False,47,48,37,0,37
2883,False,101,102,51,0,51
2884,False,23,24,16,1,15
2885,False,110,111,93,0,93
2886,False,20,21,12,0,12
2887,False,13,14,1,0,1
2888,False,71,72,30,0,30
2889,False,27,28,15,0,15
2890,False,40,41,63,0,63
2891,False,31,32,74,0,74
2892,False,40,41,24,1,23
2893,False,65,66,64,1,63
2894,False,119,120,58,0,58
2895,False,8,9,40,2,38
2896,False,19,20,12,0,12
2897,False,32,33,14,0,14
2898,False,26,27,16,0,16
2899,False,49,50,72,2,70
2900,False,92,93,44,4,40
2901,False,5,6,2,0,2
2902,False,13,14,9,0,9
2903,False,30,31,10,0,10
2904,False,69,70,73,4,69
2905,False,42,43,19,1,18
2906,False,23,24,29,0,29
2907,False,56,57,29,0,29
2908,False,24,25,13,0,13
2909,False,50,51,15,1,14
2910,False,87,88,59,0,59
2911,False,26,27,14,0,14
2912,False,68,69,40,7,33
2913,False,39,40,39,0,39
2914,False,181,182,64,5,59
2915,False,20,21,14,1,13
2916,False,9,10,9,0,9
2917,False,13,14,32,0,32
2918,False,11,12,5,1,4
2919,False,49,50,27,0,27
2920,False,20,21,4,0,4
2921,False,50,51,42,0,42
2922,False,45,46,35,0,35
2923,False,65,66,73,3,70
2924,False,28,29,34,0,34
2925,False,20,21,16,0,16
2926,False,33,34,27,0,27
2927,False,16,17,8,0,8
2928,False,62,63,86,0,86
2929,False,77,78,31,0,31
2930,False,28,29,14,0,14
2931,False,24,25,49,0,49
2932,False,9,10,2,0,2
2933,False,62,63,31,2,29
2934,False,85,86,25,0,25
2935,False,23,24,33,0,33
2936,False,85,86,54,1,53
2937,False,107,108,63,0,63
2938,False,14,15,6,0,6
2939,False,68,69,40,0,40
2940,False,37,38,67,0,67
2941,False,13,14,28,11,17
2942,False,212,213,200,4,196
2943,False,38,39,39,0,39
2944,False,53,54,26,0,26
2945,False,30,31,24,1,23
2946,False,55,56,36,0,36
2947,False,27,28,24,0,24
2948,False,24,25,43,1,42
2949,False,36,37,23,0,23
2950,False,176,177,133,2,131
2951,False,12,13,5,0,5
2952,False,15,16,7,0,7
2953,False,70,71,29,0,29
2954,False,65,66,51,3,48
2955,False,55,56,43,0,43
2956,False,14,15,0,0,0
2957,False,23,24,31,0,31
2958,False,130,131,144,2,142
2959,False,32,33,35,3,32
2960,False,24,25,8,0,8
2961,False,25,26,7,1,6
2962,False,211,212,128,1,127
2963,False,67,68,87,0,87
2964,False,35,36,97,2,95
2965,False,21,22,36,0,36
2966,False,53,54,31,0,31
2967,False,102,103,25,1,24
2968,False,180,181,63,3,60
2969,False,21,22,8,2,6
2970,False,63,64,30,0,30
2971,False,55,56,94,2,92
2972,False,31,32,78,1,77
2973,False,35,36,46,0,46
2974,False,32,33,45,1,44
2975,False,20,21,18,0,18
2976,False,47,48,77,2,75
2977,False,75,76,59,2,57
2978,False,22,23,14,0,14
2979,False,61,62,21,0,21
2980,False,57,58,52,0,52
2981,False,14,15,3,0,3
2982,False,61,62,39,0,39
2983,False,19,20,29,3,26
2984,False,24,25,53,3,50
2985,False,11,12,7,0,7
2986,False,50,51,35,0,35
2987,False,34,35,21,0,21
2988,False,48,49,43,0,43
2989,False,25,26,29,0,29
2990,False,20,21,42,0,42
2991,False,12,13,7,0,7
2992,False,77,78,43,1,42
2993,False,69,70,74,2,72
2994,False,41,42,55,0,55
2995,False,21,22,20,0,20
2996,False,72,73,42,1,41
2997,False,50,51,63,0,63
2998,False,28,29,39,1,38
2999,False,30,31,66,4,62
3000,False,163,164,134,1,133
3001,False,14,15,11,0,11
3002,False,9,10,7,0,7
3003,False,20,21,18,0,18
3004,False,44,45,18,0,18
3005,False,49,50,23,0,23
3006,False,20,21,43,2,41
3007,False,40,41,42,0,42
3008,False,57,58,70,0,70
3009,False,62,63,69,2,67
3010,False,29,30,45,0,45
3011,False,35,36,63,0,63
3012,False,6,7,24,0,24
3013,False,61,62,81,2,79
3014,False,17,18,11,1,10
3015,False,8,9,37,0,37
3016,False,47,48,40,0,40
3017,False,13,14,22,0,22
3018,False,139,140,113,0,113
3019,False,27,28,12,1,11
3020,False,67,68,82,2,80
3021,False,52,53,14,0,14
3022,False,92,93,101,0,101
3023,False,62,63,32,0,32
3024,False,49,50,34,1,33
3025,False,51,52,14,1,13
3026,False,44,45,33,0,33
3027,False,73,74,55,0,55
3028,False,56,57,77,2,75
3029,False,49,50,39,0,39
3030,False,185,186,110,0,110
3031,False,18,19,29,4,25
3032,False,32,33,23,1,22
3033,False,40,41,60,3,57
3034,False,199,200,108,4,104
3035,False,23,24,9,0,9
3036,False,36,37,17,0,17
3037,False,64,65,31,0,31
3038,False,7,8,12,2,10
3039,False,46,47,35,0,35
3040,False,18,19,9,1,8
3041,False,47,48,71,0,71
3042,False,61,62,36,0,36
3043,False,37,38,45,0,45
3044,False,69,70,68,0,68
3045,False,138,139,100,0,100
3046,False,45,46,68,1,67
3047,False,27,28,9,0,9
3048,False,135,136,24,2,22
3049,False,13,14,5,0,5
3050,False,23,24,10,0,10
3051,False,15,16,16,0,16
3052,False,51,52,49,1,48
3053,False,30,31,28,0,28
3054,False,55,56,45,3,42
3055,False,27,28,9,0,9
3056,False,68,69,48,0,48
3057,False,38,39,40,0,40
3058,False,133,134,103,2,101
3059,False,125,126,136,1,135
3060,False,79,80,32,3,29
3061,False,76,77,53,2,51
3062,False,40,41,26,0,26
3063,False,43,44,27,1,26
3064,False,13,14,6,0,6
3065,False,20,21,15,0,15
3066,False,44,45,26,0,26
3067,False,54,55,37,0,37
3068,False,35,36,71,0,71
3069,False,14,15,32,0,32
3070,False,176,177,134,1,133
3071,False,25,26,35,1,34
3072,False,99,100,84,0,84
3073,False,25,26,17,0,17
3074,False,12,13,11,0,11
3075,False,59,60,32,0,32
3076,False,31,32,15,1,14
3077,False,38,39,20,0,20
3078,False,31,32,36,1,35
3079,False,73,74,37,0,37
3080,False,46,47,19,0,19
3081,False,51,52,29,1,28
3082,False,21,22,32,0,32
3083,False,37,38,20,0,20
3084,False,47,48,45,0,45
3085,False,36,37,24,0,24
3086,False,47,48,58,0,58
3087,False,53,54,53,1,52
3088,False,54,55,37,1,36
3089,False,23,24,31,0,31
3090,False,21,22,17,0,17
3091,False,23,24,34,1,33
3092,False,18,19,11,0,11
3093,False,46,47,39,0,39
3094,False,55,56,52,12,40
3095,False,36,37,47,0,47
3096,False,30,31,6,0,6
3097,False,226,227,79,19,60
3098,False,37,38,13,4,9
3099,False,20,21,14,0,14
3100,False,15,16,16,0,16
3101,False,20,21,56,0,56
3102,False,48,49,18,0,18
3103,False,1,2,1,0,1
3104,False,22,23,7,0,7
3105,False,6,7,3,0,3
3106,False,49,50,46,0,46
3107,False,40,41,39,0,39
3108,False,10,11,10,0,10
3109,False,35,36,68,2,66
3110,False,25,26,41,0,41
3111,False,17,18,10,0,10
3112,False,19,20,13,1,12
3113,False,47,48,55,0,55
3114,False,81,82,39,0,39
3115,False,64,65,52,0,52
3116,False,19,20,20,0,20
3117,False,20,21,20,0,20
3118,False,31,32,35,2,33
3119,False,73,74,59,1,58
3120,False,19,20,25,0,25
3121,False,12,13,7,0,7
3122,False,36,37,54,0,54
3123,False,61,62,86,0,86
3124,False,32,33,34,0,34
3125,False,46,47,39,0,39
3126,False,77,78,31,0,31
3127,False,18,19,84,2,82
3128,False,9,10,37,0,37
3129,False,105,106,107,2,105
3130,False,24,25,21,1,20
3131,False,14,15,1,1,0
3132,False,54,55,46,0,46
3133,False,25,26,8,0,8
3134,False,71,72,73,1,72
3135,False,47,48,96,2,94
3136,False,33,34,57,0,57
3137,False,12,13,33,0,33
3138,False,41,42,20,0,20
3139,False,35,36,26,0,26
3140,False,46,47,70,0,70
3141,False,31,32,72,1,71
3142,False,28,29,42,0,42
3143,False,14,15,28,0,28
3144,False,99,100,102,0,102
3145,False,25,26,8,0,8
3146,False,40,41,36,0,36
3147,False,26,27,32,0,32
3148,False,16,17,5,0,5
3149,False,37,38,75,2,73
3150,False,152,153,69,0,69
3151,False,41,42,54,0,54
3152,False,22,23,9,0,9
3153,False,55,56,84,0,84
3154,False,19,20,12,0,12
3155,False,9,10,4,1,3
3156,False,83,84,37,2,35
3157,False,87,88,133,0,133
3158,False,19,20,9,0,9
3159,False,6,7,2,0,2
3160,False,26,27,23,0,23
3161,False,26,27,16,0,16
3162,False,17,18,10,0,10
3163,False,46,47,21,0,21
3164,False,29,30,34,0,34
3165,False,78,79,24,0,24
3166,False,99,100,59,4,55
3167,False,23,24,40,0,40
3168,False,78,79,60,0,60
3169,False,54,55,52,0,52
3170,False,75,76,82,0,82
3171,False,144,145,163,0,163
3172,False,47,48,40,1,39
3173,False,33,34,19,0,19
3174,False,26,27,89,2,87
3175,False,37,38,23,0,23
3176,False,73,74,51,1,50
3177,False,21,22,9,1,8
3178,False,43,44,22,1,21
3179,False,25,26,33,0,33
3180,False,45,46,59,2,57
3181,False,189,190,116,2,114
3182,False,11,12,4,1,3
3183,False,267,268,235,2,233
3184,False,30,31,64,0,64
3185,False,147,148,118,0,118
3186,False,24,25,19,0,19
3187,False,39,40,43,0,43
3188,False,129,130,118,2,116
3189,False,18,19,32,2,30
3190,False,25,26,29,0,29
3191,False,41,42,31,0,31
3192,False,32,33,16,1,15
3193,False,44,45,47,0,47
3194,False,11,12,7,0,7
3195,False,16,17,6,0,6
3196,False,11,12,32,0,32
3197,False,45,46,52,1,51
3198,False,41,42,13,0,13
3199,False,9,10,43,3,40
3200,False,60,61,69,1,68
3201,False,46,47,32,0,32
3202,False,50,51,39,0,39
3203,False,110,111,83,2,81
3204,False,76,77,27,0,27
3205,False,45,46,21,1,20
3206,False,130,131,110,4,106
3207,False,88,89,46,0,46
3208,False,77,78,35,2,33
3209,False,13,14,11,0,11
3210,False,13,14,14,0,14
3211,False,72,73,63,1,62
3212,False,74,75,31,0,31
3213,False,49,50,1,0,1
3214,False,16,17,1,0,1
3215,False,7,8,6,0,6
3216,False,85,86,29,0,29
3217,False,30,31,76,0,76
3218,False,19,20,23,1,22
3219,False,14,15,58,1,57
3220,False,32,33,58,0,58
3221,False,14,15,5,0,5
3222,False,27,28,49,0,49
3223,False,8,9,7,4,3
3224,False,50,51,53,0,53
3225,False,54,55,66,0,66
3226,False,75,76,54,0,54
3227,False,33,34,45,0,45
3228,False,60,61,80,0,80
3229,False,40,41,34,0,34
3230,False,128,129,91,0,91
3231,False,16,17,52,0,52
3232,False,51,52,36,0,36
3233,False,36,37,27,0,27
3234,False,111,112,64,0,64
3235,False,57,58,72,2,70
3236,False,46,47,21,0,21
3237,False,35,36,11,0,11
3238,False,49,50,29,0,29
3239,False,50,51,53,0,53
3240,False,49,50,48,0,48
3241,False,14,15,8,0,8
3242,False,87,88,36,0,36
3243,False,94,95,53,0,53
3244,False,32,33,55,0,55
3245,False,75,76,37,0,37
3246,False,31,32,25,0,25
3247,False,48,49,29,0,29
3248,False,31,32,38,0,38
3249,False,39,40,49,0,49
3250,False,133,134,97,2,95
3251,False,40,41,27,0,27
3252,False,150,151,116,0,116
3253,False,20,21,86,0,86
3254,False,44,45,42,0,42
3255,False,49,50,14,0,14
3256,False,30,31,67,1,66
3257,False,54,55,70,0,70
3258,False,35,36,22,0,22
3259,False,140,141,118,3,115
3260,False,41,42,10,0,10
3261,False,31,32,42,0,42
3262,False,29,30,20,0,20
3263,False,40,41,43,1,42
3264,False,21,22,19,0,19
3265,False,23,24,13,0,13
3266,False,21,22,12,0,12
3267,False,28,29,36,0,36
3268,False,37,38,16,0,16
3269,False,18,19,24,0,24
3270,False,5,6,2,0,2
3271,False,25,26,20,0,20
3272,False,49,50,27,0,27
3273,False,16,17,8,1,7
3274,False,21,22,13,0,13
3275,False,32,33,24,1,23
3276,False,33,34,55,0,55
3277,False,31,32,40,0,40
3278,False,55,56,43,0,43
3279,False,60,61,50,1,49
3280,False,40,41,45,0,45
3281,False,30,31,56,0,56
3282,False,5,6,1,0,1
3283,False,46,47,42,2,40
3284,False,94,95,54,2,52
3285,False,22,23,14,0,14
3286,False,35,36,43,0,43
3287,False,21,22,32,0,32
3288,False,39,40,12,0,12
3289,False,23,24,8,0,8
3290,False,33,34,15,0,15
3291,False,37,38,75,3,72
3292,False,20,21,20,0,20
3293,False,27,28,21,0,21
3294,False,26,27,32,0,32
3295,False,12,13,3,0,3
3296,False,16,17,5,0,5
3297,False,124,125,70,1,69
3298,False,40,41,14,0,14
3299,False,33,34,22,0,22
3300,False,72,73,41,0,41
3301,False,39,40,29,0,29
3302,False,35,36,26,0,26
3303,False,57,58,54,0,54
3304,False,9,10,2,0,2
3305,False,114,115,85,2,83
3306,False,26,27,26,0,26
3307,False,15,16,14,0,14
3308,False,54,55,27,0,27
3309,False,45,46,49,0,49
3310,False,44,45,27,0,27
3311,False,71,72,44,0,44
3312,False,18,19,14,0,14
3313,False,18,19,44,2,42
3314,False,54,55,59,4,55
3315,False,109,110,65,1,64
3316,False,62,63,33,3,30
3317,False,24,25,12,0,12
3318,False,27,28,9,0,9
3319,False,20,21,18,1,17
3320,False,23,24,70,6,64
3321,False,36,37,18,0,18
3322,False,72,73,46,0,46
3323,False,34,35,56,0,56
3324,False,12,13,2,1,1
3325,False,53,54,36,0,36
3326,False,104,105,104,0,104
3327,False,41,42,42,0,42
3328,False,17,18,3,0,3
3329,False,27,28,12,1,11
3330,False,19,20,34,0,34
3331,False,7,8,1,0,1
3332,False,92,93,71,0,71
3333,False,50,51,22,0,22
3334,False,43,44,24,0,24
3335,False,86,87,83,0,83
3336,False,40,41,46,0,46
3337,False,52,53,40,0,40
3338,False,15,16,16,1,15
3339,False,41,42,27,0,27
3340,False,38,39,28,0,28
3341,False,38,39,17,0,17
3342,False,30,31,19,0,19
3343,False,88,89,58,3,55
3344,False,47,48,40,0,40
3345,False,112,113,88,6,82
3346,False,45,46,63,1,62
3347,False,64,65,37,0,37
3348,False,44,45,29,0,29
3349,False,18,19,7,0,7
3350,False,40,41,18,1,17
3351,False,20,21,14,0,14
3352,False,12,13,30,0,30
3353,False,34,35,41,1,40
3354,False,140,141,110,1,109
3355,False,35,36,45,0,45
3356,False,14,15,8,0,8
3357,False,3,4,0,0,0
3358,False,88,89,56,0,56
3359,False,33,34,28,0,28
3360,False,43,44,17,0,17
3361,False,17,18,8,0,8
3362,False,40,41,33,1,32
3363,False,12,13,6,0,6
3364,False,25,26,36,4,32
3365,False,55,56,24,1,23
3366,False,52,53,28,0,28
3367,False,55,56,18,0,18
3368,False,23,24,52,0,52
3369,False,34,35,26,0,26
3370,False,32,33,38,2,36
3371,False,30,31,12,0,12
3372,False,82,83,41,0,41
3373,False,87,88,84,1,83
3374,False,32,33,19,0,19
3375,False,148,149,172,3,169
3376,False,54,55,46,1,45
3377,False,5,6,31,0,31
3378,False,26,27,24,1,23
3379,False,35,36,23,0,23
3380,False,43,44,24,0,24
3381,False,46,47,33,1,32
3382,False,91,92,40,3,37
3383,False,26,27,17,0,17
3384,False,38,39,81,1,80
3385,False,26,27,16,0,16
3386,False,20,21,11,0,11
3387,False,40,41,30,0,30
3388,False,88,89,41,0,41
3389,False,95,96,136,0,136
3390,False,8,9,7,0,7
3391,False,54,55,41,0,41
3392,False,24,25,16,0,16
3393,False,10,11,4,1,3
3394,False,16,17,2,1,1
3395,False,1,2,0,0,0
3396,False,24,25,10,0,10
3397,False,51,52,24,0,24
3398,False,65,66,20,2,18
3399,False,68,69,28,0,28
3400,False,61,62,39,0,39
3401,False,20,21,32,1,31
3402,False,101,102,72,1,71
3403,False,33,34,30,0,30
3404,False,8,9,51,2,49
3405,False,10,11,1,0,1
3406,False,20,21,13,0,13
3407,False,48,49,40,0,40
3408,False,7,8,0,0,0
3409,False,47,48,26,1,25
3410,False,198,199,197,4,193
3411,False,15,16,37,1,36
3412,False,38,39,92,3,89
3413,False,69,70,61,1,60
3414,False,61,62,24,0,24
3415,False,28,29,65,1,64
3416,False,4,5,3,0,3
3417,False,18,19,12,0,12
3418,False,9,10,12,0,12
3419,False,8,9,6,0,6
3420,False,35,36,8,0,8
3421,False,48,49,32,0,32
3422,False,60,61,52,0,52
3423,False,44,45,42,0,42
3424,False,36,37,47,0,47
3425,False,27,28,48,2,46
3426,False,45,46,23,2,21
3427,False,58,59,48,1,47
3428,False,44,45,27,1,26
3429,False,24,25,39,0,39
3430,False,34,35,28,0,28
3431,False,60,61,42,1,41
3432,False,58,59,76,2,74
3433,False,66,67,57,0,57
3434,False,21,22,13,0,13
3435,False,66,67,54,0,54
3436,False,52,53,43,3,40
3437,False,55,56,61,1,60
3438,False,33,34,39,0,39
3439,False,59,60,90,0,90
3440,False,20,21,13,0,13
3441,False,135,136,30,0,30
3442,False,9,10,35,1,34
3443,False,87,88,123,3,120
3444,False,40,41,28,0,28
3445,False,25,26,19,0,19
3446,False,129,130,110,2,108
3447,False,47,48,38,0,38
3448,False,13,14,31,0,31
3449,False,21,22,15,0,15
3450,False,34,35,26,0,26
3451,False,7,8,29,0,29
3452,False,36,37,13,0,13
3453,False,24,25,26,0,26
3454,False,200,201,60,0,60
3455,False,93,94,76,11,65
3456,False,65,66,120,6,114
3457,False,7,8,5,2,3
3458,False,32,33,33,1,32
3459,False,8,9,7,0,7
3460,False,92,93,38,0,38
3461,False,8,9,3,0,3
3462,False,71,72,34,3,31
3463,False,26,27,33,0,33
3464,False,27,28,78,4,74
3465,False,37,38,67,6,61
3466,False,78,79,49,0,49
3467,False,196,197,119,1,118
3468,False,88,89,69,0,69
3469,False,16,17,3,0,3
3470,False,39,40,18,0,18
3471,False,36,37,49,2,47
3472,False,14,15,9,0,9
3473,False,34,35,9,0,9
3474,False,33,34,19,0,19
3475,False,40,41,19,0,19
3476,False,12,13,7,0,7
3477,False,24,25,23,0,23
3478,False,40,41,8,0,8
3479,False,26,27,36,2,34
3480,False,30,31,34,4,30
3481,False,59,60,59,0,59
3482,False,20,21,13,0,13
3483,False,100,101,46,0,46
3484,False,78,79,73,0,73
3485,False,25,26,12,0,12
3486,False,107,108,73,0,73
3487,False,138,139,154,11,143
3488,False,50,51,55,1,54
3489,False,68,69,95,1,94
3490,False,45,46,46,0,46
3491,False,41,42,26,0,26
3492,False,29,30,40,0,40
3493,False,41,42,51,0,51
3494,False,98,99,67,2,65
3495,False,63,64,39,1,38
3496,False,22,23,42,0,42
3497,False,27,28,17,0,17
3498,False,52,53,52,1,51
3499,False,39,40,58,0,58
3500,False,46,47,26,1,25
3501,False,44,45,66,1,65
3502,False,21,22,16,0,16
3503,False,47,48,24,3,21
3504,False,74,75,40,4,36
3505,False,33,34,33,0,33
3506,False,28,29,31,0,31
3507,False,54,55,90,4,86
3508,False,32,33,19,1,18
3509,False,30,31,14,0,14
3510,False,30,31,21,0,21
3511,False,18,19,28,1,27
3512,False,25,26,16,0,16
3513,False,21,22,23,0,23
3514,False,8,9,8,0,8
3515,False,37,38,40,1,39
3516,False,98,99,95,1,94
3517,False,59,60,79,0,79
3518,False,43,44,25,0,25
3519,False,35,36,24,0,24
3520,False,47,48,43,0,43
3521,False,30,31,20,0,20
3522,False,98,99,57,0,57
3523,False,18,19,17,1,16
3524,False,26,27,32,0,32
3525,False,43,44,53,0,53
3526,False,11,12,35,1,34
3527,False,94,95,82,3,79
3528,False,47,48,17,0,17
3529,False,17,18,4,0,4
3530,False,12,13,56,1,55
3531,False,26,27,19,1,18
3532,False,21,22,80,1,79
3533,False,21,22,21,0,21
3534,False,20,21,10,0,10
3535,False,24,25,11,0,11
3536,False,20,21,17,0,17
3537,False,14,15,20,0,20
3538,False,12,13,50,0,50
3539,False,6,7,4,0,4
3540,False,31,32,28,0,28
3541,False,32,33,15,0,15
3542,False,11,12,1,1,0
3543,False,20,21,35,0,35
3544,False,32,33,94,1,93
3545,False,18,19,15,0,15
3546,False,39,40,67,5,62
3547,False,47,48,24,2,22
3548,False,26,27,7,1,6
3549,False,27,28,22,0,22
3550,False,57,58,28,0,28
3551,False,33,34,51,0,51
3552,False,9,10,0,0,0
3553,False,56,57,31,0,31
3554,False,45,46,59,0,59
3555,False,26,27,89,0,89
3556,False,147,148,208,5,203
3557,False,10,11,3,0,3
3558,False,28,29,36,0,36
3559,False,36,37,44,0,44
3560,False,57,58,38,0,38
3561,False,18,19,31,0,31
3562,False,16,17,8,0,8
3563,False,2,3,0,0,0
3564,False,32,33,28,0,28
3565,False,29,30,13,0,13
3566,False,32,33,19,0,19
3567,False,7,8,5,0,5
3568,False,56,57,48,1,47
3569,False,14,15,8,0,8
3570,False,8,9,9,1,8
3571,False,42,43,23,1,22
3572,False,42,43,35,0,35
3573,False,91,92,74,0,74
3574,False,32,33,40,0,40
3575,False,15,16,29,4,25
3576,False,69,70,44,0,44
3577,False,7,8,15,0,15
3578,False,90,91,71,3,68
3579,False,114,115,58,2,56
3580,False,42,43,31,0,31
3581,False,22,23,21,0,21
3582,False,60,61,42,1,41
3583,False,33,34,103,0,103
3584,False,39,40,57,2,55
3585,False,16,17,14,0,14
3586,False,52,53,22,0,22
3587,False,52,53,35,0,35
3588,False,8,9,2,0,2
3589,False,78,79,69,2,67
3590,False,36,37,29,0,29
3591,False,95,96,79,1,78
3592,False,77,78,36,0,36
3593,False,30,31,13,0,13
3594,False,30,31,22,1,21
3595,False,52,53,69,0,69
3596,False,33,34,26,0,26
3597,False,48,49,49,1,48
3598,False,35,36,56,0,56
3599,False,35,36,26,2,24
3600,False,50,51,18,0,18
3601,False,18,19,9,0,9
3602,False,57,58,77,0,77
3603,False,44,45,26,0,26
3604,False,35,36,46,0,46
3605,False,24,25,25,0,25
3606,False,31,32,76,0,76
3607,False,20,21,16,0,16
3608,False,15,16,5,1,4
3609,False,44,45,26,0,26
3610,False,63,64,70,0,70
3611,False,9,10,2,0,2
3612,False,19,20,6,0,6
3613,False,52,53,53,3,50
3614,False,11,12,20,1,19
3615,False,41,42,37,0,37
3616,False,55,56,32,0,32
3617,False,54,55,28,1,27
3618,False,26,27,54,1,53
3619,False,60,61,78,1,77
3620,False,8,9,10,0,10
3621,False,29,30,34,0,34
3622,False,32,33,18,2,16
3623,False,51,52,98,4,94
3624,False,42,43,27,0,27
3625,False,13,14,8,0,8
3626,False,91,92,46,0,46
3627,False,77,78,29,0,29
3628,False,16,17,20,0,20
3629,False,14,15,16,0,16
3630,False,39,40,29,1,28
3631,False,34,35,18,0,18
3632,False,77,78,74,13,61
3633,False,45,46,41,6,35
3634,False,36,37,55,1,54
3635,False,10,11,6,0,6
3636,False,14,15,6,0,6
3637,False,52,53,1,0,1
3638,False,5,6,0,0,0
3639,False,73,74,55,0,55
3640,False,23,24,33,3,30
3641,False,35,36,25,0,25
3642,False,20,21,71,0,71
3643,False,73,74,43,0,43
3644,False,48,49,20,0,20
3645,False,89,90,107,2,105
3646,False,21,22,11,0,11
3647,False,77,78,67,2,65
3648,False,100,101,65,0,65
3649,False,32,33,39,1,38
3650,False,9,10,33,0,33
3651,False,13,14,38,0,38
3652,False,26,27,8,1,7
3653,False,50,51,34,1,33
3654,False,122,123,130,0,130
3655,False,47,48,30,2,28
3656,False,31,32,30,0,30
3657,False,110,111,101,1,100
3658,False,36,37,38,1,37
3659,False,28,29,30,0,30
3660,False,6,7,28,1,27
3661,False,100,101,103,15,88
3662,False,32,33,17,0,17
3663,False,74,75,46,0,46
3664,False,72,73,61,0,61
3665,False,123,124,94,0,94
3666,False,52,53,24,0,24
3667,False,76,77,59,3,56
3668,False,65,66,73,5,68
3669,False,51,52,41,2,39
3670,False,41,42,38,1,37
3671,False,50,51,29,0,29
3672,False,7,8,6,0,6
3673,False,7,8,6,0,6
3674,False,52,53,27,0,27
3675,False,75,76,66,1,65
3676,False,5,6,4,1,3
3677,False,31,32,22,1,21
3678,False,27,28,39,0,39
3679,False,12,13,10,0,10
3680,False,38,39,38,0,38
3681,False,6,7,3,0,3
3682,False,34,35,12,0,12
3683,False,54,55,49,0,49
3684,False,25,26,46,0,46
3685,False,75,76,85,0,85
3686,False,24,25,15,0,15
3687,False,8,9,12,0,12
3688,False,43,44,86,0,86
3689,False,15,16,32,1,31
3690,False,34,35,16,0,16
3691,False,39,40,47,0,47
3692,False,66,67,51,1,50
3693,False,78,79,74,5,69
3694,False,30,31,18,0,18
3695,False,45,46,22,1,21
3696,False,46,47,32,0,32
3697,False,56,57,50,0,50
3698,False,42,43,17,0,17
3699,False,24,25,32,0,32
3700,False,18,19,13,0,13
3701,False,18,19,101,2,99
3702,False,40,41,41,0,41
3703,False,29,30,18,0,18
3704,False,62,63,21,1,20
3705,False,7,8,5,3,2
3706,False,28,29,46,0,46
3707,False,7,8,5,0,5
3708,False,168,169,70,2,68
3709,False,25,26,7,0,7
3710,False,40,41,19,0,19
3711,False,80,81,64,3,61
3712,False,70,71,126,4,122
3713,False,42,43,71,0,71
3714,False,28,29,34,0,34
3715,False,43,44,50,1,49
3716,False,44,45,47,0,47
3717,False,32,33,12,0,12
3718,False,61,62,52,0,52
3719,False,9,10,15,0,15
3720,False,39,40,60,0,60
3721,False,4,5,3,0,3
3722,False,8,9,30,1,29
3723,False,56,57,93,1,92
3724,False,20,21,48,0,48
3725,False,56,57,39,0,39
3726,False,46,47,38,0,38
3727,False,38,39,50,0,50
3728,False,241,242,89,3,86
3729,False,35,36,34,0,34
3730,False,25,26,45,3,42
3731,False,24,25,22,0,22
3732,False,98,99,98,1,97
3733,False,76,77,67,0,67
3734,False,80,81,50,1,49
3735,False,45,46,43,0,43
3736,False,84,85,72,1,71
3737,False,25,26,11,0,11
3738,False,34,35,33,0,33
3739,False,17,18,41,1,40
3740,False,25,26,37,0,37
3741,False,62,63,71,0,71
3742,False,83,84,93,0,93
3743,False,15,16,19,3,16
3744,False,99,100,80,0,80
3745,False,41,42,46,0,46
3746,False,39,40,40,1,39
3747,False,40,41,28,1,27
3748,False,64,65,24,0,24
3749,False,48,49,33,0,33
3750,False,28,29,14,1,13
3751,False,27,28,33,1,32
3752,False,31,32,42,2,40
3753,False,19,20,31,0,31
3754,False,4,5,3,0,3
3755,False,120,121,71,0,71
3756,False,39,40,47,0,47
3757,False,49,50,48,0,48
3758,False,38,39,46,0,46
3759,False,42,43,86,0,86
3760,False,55,56,53,1,52
3761,False,37,38,35,0,35
3762,False,22,23,22,0,22
3763,False,5,6,6,1,5
3764,False,24,25,36,1,35
3765,False,24,25,27,0,27
3766,False,46,47,24,0,24
3767,False,50,51,41,0,41
3768,False,13,14,5,0,5
3769,False,27,28,24,0,24
3770,False,30,31,30,0,30
3771,False,51,52,62,5,57
3772,False,86,87,57,0,57
3773,False,41,42,23,1,22
3774,False,60,61,37,0,37
3775,False,50,51,49,1,48
3776,False,44,45,42,0,42
3777,False,78,79,73,0,73
3778,False,54,55,61,0,61
3779,False,51,52,70,0,70
3780,False,83,84,72,0,72
3781,False,51,52,37,3,34
3782,False,180,181,84,2,82
3783,False,69,70,44,0,44
3784,False,138,139,141,4,137
3785,False,27,28,12,0,12
3786,False,9,10,6,1,5
3787,False,35,36,54,0,54
3788,False,24,25,21,0,21
3789,False,68,69,25,1,24
3790,False,50,51,20,0,20
3791,False,33,34,65,2,63
3792,False,35,36,46,0,46
3793,False,33,34,13,0,13
3794,False,26,27,105,3,102
3795,False,24,25,45,0,45
3796,False,138,139,98,3,95
3797,False,107,108,72,2,70
3798,False,99,100,98,1,97
3799,False,42,43,48,1,47
3800,False,24,25,43,0,43
3801,False,26,27,16,1,15
3802,False,49,50,53,1,52
3803,False,38,39,50,3,47
3804,False,40,41,14,0,14
3805,False,50,51,5,0,5
3806,False,16,17,0,0,0
3807,False,5,6,4,0,4
3808,False,35,36,56,0,56
3809,False,44,45,37,0,37
3810,False,36,37,15,0,15
3811,False,18,19,45,3,42
3812,False,25,26,19,0,19
3813,False,9,10,4,0,4
3814,False,9,10,29,0,29
3815,False,108,109,18,0,18
3816,False,9,10,36,1,35
3817,False,67,68,39,1,38
3818,False,5,6,4,0,4
3819,False,31,32,22,0,22
3820,False,48,49,35,0,35
3821,False,31,32,23,0,23
3822,False,20,21,43,2,41
3823,False,71,72,81,1,80
3824,False,33,34,21,0,21
3825,False,102,103,66,0,66
3826,False,38,39,25,1,24
3827,False,68,69,67,0,67
3828,False,178,179,99,1,98
3829,False,59,60,70,1,69
3830,False,68,69,51,0,51
3831,False,16,17,13,2,11
3832,False,41,42,57,0,57
3833,False,19,20,38,0,38
3834,False,12,13,15,0,15
3835,False,31,32,13,0,13
3836,False,44,45,43,2,41
3837,False,90,91,97,0,97
3838,False,47,48,30,1,29
3839,False,49,50,23,0,23
3840,False,72,73,60,0,60
3841,False,15,16,6,0,6
3842,False,68,69,67,2,65
3843,False,82,83,76,0,76
3844,False,39,40,48,0,48
3845,False,10,11,7,0,7
3846,False,22,23,21,0,21
3847,False,31,32,35,0,35
3848,False,83,84,67,0,67
3849,False,57,58,35,0,35
3850,False,33,34,41,0,41
3851,False,33,34,22,0,22
3852,False,11,12,4,0,4
3853,False,21,22,49,0,49
3854,False,38,39,36,0,36
3855,False,52,53,45,0,45
3856,False,42,43,51,1,50
3857,False,32,33,12,0,12
3858,False,2,3,2,0,2
3859,False,49,50,97,0,97
3860,False,19,20,7,0,7
3861,False,39,40,20,1,19
3862,False,101,102,76,0,76
3863,False,43,44,26,0,26
3864,False,75,76,89,2,87
3865,False,22,23,40,2,38
3866,False,29,30,21,0,21
3867,False,29,30,26,0,26
3868,False,38,39,56,1,55
3869,False,3,4,4,0,4
3870,False,22,23,10,0,10
3871,False,30,31,17,0,17
3872,False,42,43,79,1,78
3873,False,48,49,23,2,21
3874,False,17,18,7,0,7
3875,False,44,45,50,1,49
3876,False,48,49,40,0,40
3877,False,24,25,11,0,11
3878,False,32,33,39,0,39
3879,False,12,13,7,0,7
3880,False,16,17,5,0,5
3881,False,23,24,25,1,24
3882,False,58,59,44,3,41
3883,False,52,53,48,2,46
3884,False,18,19,4,1,3
3885,False,57,58,31,2,29
3886,False,27,28,43,1,42
3887,False,63,64,61,0,61
3888,False,33,34,41,0,41
3889,False,81,82,29,1,28
3890,False,83,84,52,1,51
3891,False,12,13,12,0,12
3892,False,8,9,2,0,2
3893,False,34,35,17,0,17
3894,False,28,29,22,0,22
3895,False,68,69,37,0,37
3896,False,36,37,106,0,106
3897,False,29,30,63,4,59
3898,False,36,37,31,0,31
3899,False,12,13,4,0,4
3900,False,29,30,49,1,48
3901,False,68,69,34,1,33
3902,False,27,28,30,0,30
3903,False,51,52,45,1,44
3904,False,41,42,17,0,17
3905,False,33,34,51,0,51
3906,False,56,57,18,0,18
3907,False,40,41,17,0,17
3908,False,25,26,12,0,12
3909,False,39,40,56,1,55
3910,False,45,46,34,0,34
3911,False,26,27,22,0,22
3912,False,34,35,34,0,34
3913,False,27,28,21,0,21
3914,False,26,27,12,1,11
3915,False,37,38,58,0,58
3916,False,26,27,44,1,43
3917,False,11,12,30,1,29
3918,False,26,27,13,0,13
3919,False,43,44,28,0,28
3920,False,34,35,40,0,40
3921,False,61,62,17,1,16
3922,False,27,28,9,0,9
3923,False,31,32,41,1,40
3924,False,37,38,141,0,141
3925,False,39,40,11,4,7
3926,False,38,39,26,0,26
3927,False,27,28,8,0,8
3928,False,18,19,18,0,18
3929,False,32,33,7,1,6
3930,False,39,40,82,1,81
3931,False,63,64,31,0,31
3932,False,50,51,74,0,74
3933,False,36,37,31,0,31
3934,False,53,54,44,1,43
3935,False,29,30,19,0,19
3936,False,46,47,35,2,33
3937,False,11,12,7,0,7
3938,False,17,18,8,0,8
3939,False,23,24,18,0,18
3940,False,39,40,55,0,55
3941,False,119,120,85,3,82
3942,False,44,45,30,0,30
3943,False,41,42,45,1,44
3944,False,41,42,25,0,25
3945,False,37,38,43,1,42
3946,False,12,13,21,0,21
3947,False,33,34,19,2,17
3948,False,11,12,3,0,3
3949,False,10,11,27,0,27
3950,False,30,31,21,0,21
3951,False,46,47,89,3,86
3952,False,81,82,91,0,91
3953,False,28,29,89,0,89
3954,False,6,7,2,0,2
3955,False,2,3,1,0,1
3956,False,12,13,4,0,4
3957,False,51,52,45,0,45
3958,False,57,58,37,14,23
3959,False,36,37,21,0,21
3960,False,34,35,19,0,19
3961,False,91,92,61,2,59
3962,False,36,37,17,0,17
3963,False,14,15,10,0,10
3964,False,22,23,35,1,34
3965,False,23,24,10,0,10
3966,False,46,47,28,1,27
3967,False,52,53,30,0,30
3968,False,19,20,9,0,9
3969,False,39,40,46,0,46
3970,False,74,75,47,0,47
3971,False,62,63,110,0,110
3972,False,12,13,4,1,3
3973,False,34,35,32,1,31
3974,False,12,13,8,1,7
3975,False,131,132,59,3,56
3976,False,50,51,56,1,55
3977,False,28,29,79,1,78
3978,False,34,35,26,0,26
3979,False,48,49,55,2,53
3980,False,66,67,26,1,25
3981,False,16,17,8,0,8
3982,False,14,15,57,0,57
3983,False,85,86,41,0,41
3984,False,74,75,31,1,30
3985,False,46,47,17,0,17
3986,False,15,16,6,0,6
3987,False,48,49,70,0,70
3988,False,54,55,68,1,67
3989,False,71,72,151,0,151
3990,False,55,56,66,0,66
3991,False,154,155,58,1,57
3992,False,62,63,29,0,29
3993,False,41,42,65,1,64
3994,False,34,35,16,0,16
3995,False,33,34,33,1,32
3996,False,13,14,14,0,14
3997,False,37,38,17,0,17
3998,False,13,14,31,0,31
3999,False,19,20,19,0,19
4000,False,22,23,47,0,47
4001,False,38,39,27,0,27
4002,False,20,21,6,0,6
4003,False,6,7,4,0,4
4004,False,94,95,66,0,66
4005,False,43,44,79,0,79
4006,False,27,28,28,0,28
4007,False,47,48,36,0,36
4008,False,27,28,63,3,60
4009,False,2,3,2,0,2
4010,False,16,17,33,0,33
4011,False,32,33,18,0,18
4012,False,47,48,72,0,72
4013,False,22,23,12,0,12
4014,False,19,20,6,0,6
4015,False,42,43,26,0,26
4016,False,13,14,30,14,16
4017,False,63,64,39,0,39
4018,False,67,68,24,2,22
4019,False,41,42,50,0,50
4020,False,30,31,51,2,49
4021,False,28,29,12,0,12
4022,False,45,46,20,0,20
4023,False,54,55,27,0,27
4024,False,13,14,9,0,9
4025,False,44,45,26,0,26
4026,False,19,20,47,0,47
4027,False,25,26,24,0,24
4028,False,30,31,48,0,48
4029,False,105,106,87,1,86
4030,False,105,106,119,1,118
4031,False,63,64,30,0,30
4032,False,28,29,7,0,7
4033,False,19,20,27,0,27
4034,False,24,25,25,0,25
4035,False,31,32,28,0,28
4036,False,19,20,12,0,12
4037,False,68,69,52,1,51
4038,False,28,29,21,1,20
4039,False,35,36,17,0,17
4040,False,140,141,114,2,112
4041,False,15,16,9,1,8
4042,False,30,31,42,0,42
4043,False,30,31,19,0,19
4044,False,25,26,10,0,10
4045,False,68,69,55,3,52
4046,False,162,163,82,1,81
4047,False,25,26,70,0,70
4048,False,30,31,43,0,43
4049,False,77,78,84,0,84
4050,False,41,42,56,2,54
4051,False,10,11,16,0,16
4052,False,79,80,64,0,64
4053,False,58,59,87,1,86
4054,False,40,41,48,1,47
4055,False,54,55,54,1,53
4056,False,112,113,82,0,82
4057,False,135,136,139,1,138
4058,False,8,9,13,0,13
4059,False,52,53,34,0,34
4060,False,52,53,80,0,80
4061,False,26,27,22,0,22
4062,False,31,32,64,2,62
4063,False,114,115,52,0,52
4064,False,43,44,54,0,54
4065,False,35,36,38,1,37
4066,False,56,57,35,2,33
4067,False,67,68,56,5,51
4068,False,69,70,50,7,43
4069,False,10,11,9,0,9
4070,False,33,34,20,2,18
4071,False,107,108,120,0,120
4072,False,50,51,80,1,79
4073,False,29,30,16,0,16
4074,False,20,21,17,0,17
4075,False,15,16,5,0,5
4076,False,22,23,40,2,38
4077,False,24,25,47,4,43
4078,False,144,145,98,1,97
4079,False,15,16,72,0,72
4080,False,31,32,51,1,50
4081,False,85,86,50,0,50
4082,False,40,41,22,0,22
4083,False,61,62,56,0,56
4084,False,23,24,46,0,46
4085,False,20,21,31,0,31
4086,False,27,28,42,1,41
4087,False,61,62,52,0,52
4088,False,62,63,80,5,75
4089,False,18,19,14,0,14
4090,False,36,37,15,0,15
4091,False,70,71,80,0,80
4092,False,14,15,33,0,33
4093,False,12,13,13,0,13
4094,False,100,101,53,1,52
4095,False,124,125,137,2,135
4096,False,33,34,13,0,13
4097,False,24,25,7,0,7
4098,False,28,29,48,0,48
4099,False,14,15,1,1,0
4100,False,14,15,6,0,6
4101,False,43,44,73,0,73
4102,False,69,70,95,0,95
4103,False,25,26,44,1,43
4104,False,26,27,14,0,14
4105,False,23,24,18,0,18
4106,False,52,53,121,3,118
4107,False,54,55,42,0,42
4108,False,12,13,1,0,1
4109,False,17,18,2,0,2
4110,False,55,56,53,0,53
4111,False,17,18,41,0,41
4112,False,62,63,49,5,44
4113,False,40,41,26,1,25
4114,False,20,21,22,0,22
4115,False,22,23,40,0,40
4116,False,43,44,36,1,35
4117,False,48,49,26,0,26
4118,False,30,31,42,0,42
4119,False,20,21,12,0,12
4120,False,100,101,72,2,70
4121,False,68,69,49,0,49
4122,False,33,34,32,0,32
4123,False,23,24,35,0,35
4124,False,55,56,58,1,57
4125,False,38,39,59,0,59
4126,False,61,62,41,5,36
4127,False,51,52,27,0,27
4128,False,42,43,30,0,30
4129,False,55,56,50,0,50
4130,False,15,16,17,0,17
4131,False,35,36,13,0,13
4132,False,141,142,91,0,91
4133,False,62,63,78,4,74
4134,False,33,34,21,0,21
4135,False,55,56,93,3,90
4136,False,44,45,105,3,102
4137,False,20,21,26,0,26
4138,False,45,46,27,0,27
4139,False,44,45,72,1,71
4140,False,40,41,105,2,103
4141,False,26,27,29,5,24
4142,False,26,27,26,0,26
4143,False,37,38,61,0,61
4144,False,34,35,16,0,16
4145,False,79,80,84,2,82
4146,False,35,36,45,1,44
4147,False,10,11,57,1,56
4148,False,10,11,25,2,23
4149,False,36,37,16,0,16
4150,False,52,53,25,1,24
4151,False,66,67,40,0,40
4152,False,18,19,11,1,10
4153,False,30,31,17,0,17
4154,False,42,43,43,0,43
4155,False,49,50,143,1,142
4156,False,31,32,41,1,40
4157,False,54,55,27,1,26
4158,False,67,68,49,0,49
4159,False,62,63,18,1,17
4160,False,51,52,10,2,8
4161,False,7,8,1,0,1
4162,False,36,37,24,0,24
4163,False,75,76,68,0,68
4164,False,61,62,14,0,14
4165,False,36,37,29,1,28
4166,False,46,47,88,0,88
4167,False,25,26,27,0,27
4168,False,61,62,77,2,75
4169,False,10,11,58,3,55
4170,False,13,14,8,0,8
4171,False,79,80,46,0,46
4172,False,42,43,7,1,6
4173,False,47,48,63,0,63
4174,False,32,33,27,0,27
4175,False,29,30,10,0,10
4176,False,62,63,67,2,65
4177,False,31,32,53,0,53
4178,False,46,47,58,2,56
4179,False,27,28,25,0,25
4180,False,34,35,18,0,18
4181,False,48,49,52,0,52
4182,False,18,19,28,0,28
4183,False,52,53,29,0,29
4184,False,36,37,65,0,65
4185,False,13,14,9,0,9
4186,False,11,12,6,0,6
4187,False,35,36,21,0,21
4188,False,35,36,27,0,27
4189,False,31,32,26,1,25
4190,False,15,16,18,1,17
4191,False,29,30,24,0,24
4192,False,43,44,68,0,68
4193,False,25,26,31,0,31
4194,False,38,39,19,0,19
4195,False,19,20,9,0,9
4196,False,51,52,31,0,31
4197,False,76,77,74,0,74
4198,False,105,106,77,3,74
4199,False,65,66,40,0,40
4200,False,59,60,40,0,40
4201,False,28,29,19,0,19
4202,False,54,55,39,1,38
4203,False,58,59,55,17,38
4204,False,44,45,17,0,17
4205,False,97,98,25,0,25
4206,False,33,34,22,0,22
4207,False,34,35,15,0,15
4208,False,66,67,40,1,39
4209,False,40,41,48,0,48
4210,False,136,137,82,0,82
4211,False,22,23,13,0,13
4212,False,61,62,45,1,44
4213,False,46,47,23,1,22
4214,False,40,41,82,0,82
4215,False,83,84,50,0,50
4216,False,52,53,21,0,21
4217,False,57,58,43,0,43
4218,False,24,25,15,0,15
4219,False,17,18,31,12,19
4220,False,21,22,4,0,4
4221,False,33,34,18,1,17
4222,False,84,85,70,1,69
4223,False,37,38,14,0,14
4224,False,79,80,71,0,71
4225,False,35,36,62,0,62
4226,False,30,31,12,1,11
4227,False,13,14,2,0,2
4228,False,24,25,9,0,9
4229,False,39,40,51,0,51
4230,False,2,3,0,0,0
4231,False,65,66,52,1,51
4232,False,32,33,35,0,35
4233,False,51,52,36,2,34
4234,False,33,34,42,1,41
4235,False,37,38,93,0,93
4236,False,62,63,62,1,61
4237,False,39,40,23,0,23
4238,False,47,48,43,0,43
4239,False,34,35,37,0,37
4240,False,4,5,1,1,0
4241,False,72,73,19,1,18
4242,False,58,59,28,1,27
4243,False,25,26,14,0,14
4244,False,15,16,12,0,12
4245,False,18,19,11,2,9
4246,False,34,35,15,0,15
4247,False,46,47,54,0,54
4248,False,51,52,28,0,28
4249,False,8,9,4,2,2
4250,False,12,13,20,0,20
4251,False,58,59,22,1,21
4252,False,58,59,26,0,26
4253,False,59,60,63,1,62
4254,False,64,65,49,0,49
4255,False,54,55,87,3,84
4256,False,2,3,4,0,4
4257,False,10,11,3,1,2
4258,False,10,11,5,2,3
4259,False,39,40,58,0,58
4260,False,23,24,26,0,26
4261,False,68,69,36,3,33
4262,False,46,47,57,0,57
4263,False,32,33,39,1,38
4264,False,48,49,23,0,23
4265,False,19,20,12,0,12
4266,False,26,27,11,0,11
4267,False,22,23,15,0,15
4268,False,37,38,24,0,24
4269,False,57,58,57,1,56
4270,False,134,135,137,0,137
4271,False,46,47,18,0,18
4272,False,77,78,125,5,120
4273,False,13,14,5,0,5
4274,False,64,65,73,0,73
4275,False,17,18,35,1,34
4276,False,43,44,79,1,78
4277,False,38,39,59,6,53
4278,False,45,46,39,0,39
4279,False,63,64,23,6,17
4280,False,23,24,36,1,35
4281,False,44,45,49,0,49
4282,False,21,22,11,0,11
4283,False,31,32,31,1,30
4284,False,49,50,19,0,19
4285,False,79,80,76,0,76
4286,False,50,51,47,0,47
4287,False,24,25,14,0,14
4288,False,24,25,76,0,76
4289,False,28,29,8,0,8
4290,False,175,176,109,1,108
4291,False,21,22,15,0,15
4292,False,56,57,60,2,58
4293,False,36,37,30,0,30
4294,False,21,22,18,0,18
4295,False,34,35,67,0,67
4296,False,108,109,79,0,79
4297,False,190,191,130,0,130
4298,False,57,58,51,0,51
4299,False,53,54,51,0,51
4300,False,32,33,39,2,37
4301,False,68,69,43,3,40
4302,False,39,40,58,0,58
4303,False,66,67,55,2,53
4304,False,28,29,37,0,37
4305,False,11,12,48,1,47
4306,False,83,84,51,0,51
4307,False,82,83,96,0,96
4308,False,4,5,3,1,2
4309,False,33,34,79,1,78
4310,False,20,21,33,2,31
4311,False,19,20,19,0,19
4312,False,32,33,70,3,67
4313,False,53,54,46,0,46
4314,False,37,38,27,0,27
4315,False,23,24,31,0,31
4316,False,100,101,31,1,30
4317,False,39,40,34,0,34
4318,False,16,17,14,0,14
4319,False,55,56,31,0,31
4320,False,27,28,33,0,33
4321,False,56,57,46,0,46
4322,False,43,44,46,1,45
4323,False,6,7,5,0,5
4324,False,35,36,29,1,28
4325,False,39,40,19,0,19
4326,False,86,87,35,0,35
4327,False,46,47,30,0,30
4328,False,34,35,13,0,13
4329,False,39,40,58,0,58
4330,False,13,14,58,0,58
4331,False,28,29,15,0,15
4332,False,66,67,95,0,95
4333,False,79,80,151,9,142
4334,False,9,10,21,0,21
4335,False,48,49,26,0,26
4336,False,33,34,19,0,19
4337,False,43,44,39,1,38
4338,False,11,12,6,0,6
4339,False,54,55,54,0,54
4340,False,123,124,49,1,48
4341,False,39,40,69,0,69
4342,False,36,37,65,3,62
4343,False,186,187,87,2,85
4344,False,33,34,46,0,46
4345,False,12,13,14,0,14
4346,False,10,11,24,9,15
4347,False,14,15,14,0,14
4348,False,79,80,48,0,48
4349,False,68,69,18,2,16
4350,False,21,22,44,3,41
4351,False,29,30,12,0,12
4352,False,17,18,9,0,9
4353,False,89,90,42,0,42
4354,False,35,36,49,0,49
4355,False,83,84,66,2,64
4356,False,44,45,24,0,24
4357,False,12,13,7,0,7
4358,False,22,23,23,0,23
4359,False,28,29,11,1,10
4360,False,164,165,107,0,107
4361,False,96,97,81,1,80
4362,False,44,45,16,0,16
4363,False,20,21,7,0,7
4364,False,71,72,77,0,77
4365,False,16,17,14,0,14
4366,False,36,37,12,0,12
4367,False,64,65,73,2,71
4368,False,51,52,29,0,29
4369,False,35,36,8,0,8
4370,False,18,19,9,0,9
4371,False,24,25,19,0,19
4372,False,40,41,61,1,60
4373,False,61,62,33,0,33
4374,False,35,36,32,0,32
4375,False,19,20,5,0,5
4376,False,43,44,76,2,74
4377,False,42,43,26,1,25
4378,False,17,18,10,0,10
4379,False,79,80,36,0,36
4380,False,37,38,19,1,18
4381,False,29,30,12,2,10
4382,False,18,19,16,0,16
4383,False,33,34,57,4,53
4384,False,45,46,17,0,17
4385,False,29,30,48,0,48
4386,False,35,36,83,0,83
4387,False,27,28,16,0,16
4388,False,21,22,10,0,10
4389,False,36,37,22,0,22
4390,False,104,105,62,0,62
4391,False,16,17,7,0,7
4392,False,43,44,39,0,39
4393,False,40,41,52,0,52
4394,False,18,19,9,1,8
4395,False,114,115,94,0,94
4396,False,37,38,27,0,27
4397,False,40,41,65,0,65
4398,False,47,48,17,0,17
4399,False,38,39,23,0,23
4400,False,23,24,35,0,35
4401,False,51,52,70,0,70
4402,False,19,20,44,1,43
4403,False,66,67,47,0,47
4404,False,26,27,36,4,32
4405,False,62,63,77,0,77
4406,False,71,72,52,2,50
4407,False,7,8,3,0,3
4408,False,42,43,23,0,23
4409,False,54,55,25,0,25
4410,False,8,9,43,0,43
4411,False,26,27,13,0,13
4412,False,8,9,3,0,3
4413,False,48,49,50,0,50
4414,False,86,87,81,0,81
4415,False,260,261,281,3,278
4416,False,3,4,65,1,64
4417,False,88,89,83,1,82
4418,False,29,30,39,0,39
4419,False,4,5,1,1,0
4420,False,83,84,100,2,98
4421,False,31,32,29,0,29
4422,False,6,7,5,0,5
4423,False,71,72,34,1,33
4424,False,33,34,11,0,11
4425,False,21,22,14,0,14
4426,False,48,49,14,0,14
4427,False,32,33,28,0,28
4428,False,16,17,3,0,3
4429,False,40,41,31,0,31
4430,False,56,57,23,2,21
4431,False,44,45,14,0,14
4432,False,38,39,45,3,42
4433,False,31,32,18,0,18
4434,False,113,114,88,1,87
4435,False,97,98,64,0,64
4436,False,66,67,71,0,71
4437,False,39,40,13,0,13
4438,False,42,43,19,0,19
4439,False,42,43,61,1,60
4440,False,69,70,47,3,44
4441,False,11,12,15,0,15
4442,False,41,42,92,0,92
4443,False,10,11,3,0,3
4444,False,10,11,6,0,6
4445,False,48,49,46,0,46
4446,False,36,37,33,0,33
4447,False,30,31,58,1,57
4448,False,28,29,32,0,32
4449,False,7,8,3,2,1
4450,False,36,37,24,1,23
4451,False,27,28,13,0,13
4452,False,116,117,107,18,89
4453,False,20,21,10,0,10
4454,False,58,59,17,0,17
4455,False,5,6,13,0,13
4456,False,36,37,9,2,7
4457,False,16,17,8,0,8
4458,False,89,90,99,0,99
4459,False,8,9,4,2,2
4460,False,38,39,20,0,20
4461,False,21,22,9,0,9
4462,False,25,26,45,0,45
4463,False,69,70,32,3,29
4464,False,35,36,26,0,26
4465,False,18,19,16,0,16
4466,False,63,64,96,0,96
4467,False,53,54,31,0,31
4468,False,21,22,48,0,48
4469,False,21,22,2,0,2
4470,False,112,113,63,0,63
4471,False,16,17,30,0,30
4472,False,8,9,7,0,7
4473,False,84,85,89,1,88
4474,False,92,93,110,1,109
4475,False,60,61,30,0,30
4476,False,279,280,156,0,156
4477,False,22,23,19,0,19
4478,False,29,30,61,1,60
4479,False,68,69,69,1,68
4480,False,61,62,37,0,37
4481,False,15,16,18,0,18
4482,False,46,47,28,0,28
4483,False,46,47,65,2,63
4484,False,48,49,60,0,60
4485,False,29,30,16,0,16
4486,False,44,45,24,0,24
4487,False,22,23,9,1,8
4488,False,13,14,39,0,39
4489,False,58,59,44,0,44
4490,False,79,80,86,0,86
4491,False,63,64,60,2,58
4492,False,28,29,23,0,23
4493,False,92,93,69,0,69
4494,False,18,19,18,1,17
4495,False,57,58,59,4,55
4496,False,62,63,35,1,34
4497,False,16,17,28,0,28
4498,False,4,5,8,0,8
4499,False,23,24,35,0,35
4500,False,57,58,42,0,42
4501,False,49,50,21,1,20
4502,False,188,189,48,3,45
4503,False,14,15,29,0,29
4504,False,38,39,20,0,20
4505,False,51,52,123,0,123
4506,False,150,151,128,0,128
4507,False,17,18,24,1,23
4508,False,46,47,58,0,58
4509,False,96,97,72,1,71
4510,False,26,27,15,0,15
4511,False,36,37,47,0,47
4512,False,32,33,32,0,32
4513,False,44,45,89,0,89
4514,False,37,38,28,0,28
4515,False,126,127,136,0,136
4516,False,38,39,17,0,17
4517,False,29,30,18,0,18
4518,False,30,31,23,1,22
4519,False,44,45,46,0,46
4520,False,31,32,13,2,11
4521,False,32,33,24,0,24
4522,False,24,25,45,2,43
4523,False,45,46,17,1,16
4524,False,19,20,55,0,55
4525,False,39,40,38,1,37
4526,False,15,16,54,0,54
4527,False,42,43,41,0,41
4528,False,31,32,54,2,52
4529,False,97,98,65,1,64
4530,False,28,29,22,0,22
4531,False,21,22,17,0,17
4532,False,27,28,42,0,42
4533,False,24,25,23,1,22
4534,False,24,25,39,0,39
4535,False,17,18,7,1,6
4536,False,21,22,34,1,33
4537,False,16,17,14,0,14
4538,False,22,23,7,1,6
4539,False,46,47,24,2,22
4540,False,14,15,7,0,7
4541,False,22,23,35,0,35
4542,False,12,13,6,0,6
4543,False,47,48,44,0,44
4544,False,47,48,36,2,34
4545,False,30,31,14,0,14
4546,False,25,26,12,0,12
4547,False,8,9,5,0,5
4548,False,20,21,12,0,12
4549,False,43,44,26,0,26
4550,False,58,59,80,10,70
4551,False,5,6,3,1,2
4552,False,53,54,99,0,99
4553,False,38,39,29,0,29
4554,False,80,81,51,5,46
4555,False,12,13,14,0,14
4556,False,18,19,15,0,15
4557,False,12,13,7,0,7
4558,False,4,5,8,0,8
4559,False,22,23,40,1,39
4560,False,65,66,31,0,31
4561,False,49,50,110,0,110
4562,False,11,12,1,0,1
4563,False,16,17,13,0,13
4564,False,18,19,30,0,30
4565,False,164,165,137,1,136
4566,False,100,101,81,1,80
4567,False,11,12,30,0,30
4568,False,86,87,48,2,46
4569,False,56,57,81,0,81
4570,False,59,60,45,0,45
4571,False,32,33,28,0,28
4572,False,29,30,54,1,53
4573,False,38,39,18,0,18
4574,False,70,71,78,2,76
4575,False,37,38,58,0,58
4576,False,32,33,15,0,15
4577,False,18,19,12,0,12
4578,False,29,30,16,2,14
4579,False,30,31,34,0,34
4580,False,57,58,19,0,19
4581,False,6,7,8,1,7
4582,False,92,93,74,0,74
4583,False,63,64,91,2,89
4584,False,10,11,2,0,2
4585,False,42,43,48,0,48
4586,False,48,49,30,1,29
4587,False,29,30,39,0,39
4588,False,56,57,12,2,10
4589,False,27,28,16,0,16
4590,False,62,63,59,23,36
4591,False,80,81,55,2,53
4592,False,34,35,22,1,21
4593,False,8,9,7,1,6
4594,False,49,50,28,1,27
4595,False,26,27,48,0,48
4596,False,46,47,19,0,19
4597,False,29,30,27,0,27
4598,False,38,39,53,1,52
4599,False,23,24,35,2,33
4600,False,53,54,25,1,24
4601,False,64,65,39,0,39
4602,False,53,54,72,1,71
4603,False,74,75,75,1,74
4604,False,68,69,53,2,51
4605,False,53,54,69,0,69
4606,False,37,38,16,0,16
4607,False,33,34,14,0,14
4608,False,56,57,17,0,17
4609,False,36,37,22,0,22
4610,False,11,12,17,0,17
4611,False,14,15,16,0,16
4612,False,34,35,42,1,41
4613,False,33,34,15,0,15
4614,False,33,34,15,0,15
4615,False,36,37,47,0,47
4616,False,22,23,11,0,11
4617,False,19,20,31,0,31
4618,False,49,50,56,0,56
4619,False,27,28,7,0,7
4620,False,19,20,14,0,14
4621,False,26,27,15,1,14
4622,False,80,81,47,0,47
4623,False,7,8,2,0,2
4624,False,49,50,30,0,30
4625,False,40,41,30,1,29
4626,False,37,38,23,2,21
4627,False,22,23,17,0,17
4628,False,48,49,21,0,21
4629,False,30,31,35,4,31
4630,False,14,15,1,0,1
4631,False,18,19,11,0,11
4632,False,76,77,42,1,41
4633,False,32,33,14,0,14
4634,False,63,64,78,0,78
4635,False,31,32,112,0,112
4636,False,6,7,5,0,5
4637,False,16,17,2,0,2
4638,False,6,7,5,0,5
4639,False,25,26,5,0,5
4640,False,104,105,84,2,82
4641,False,24,25,9,0,9
4642,False,83,84,37,0,37
4643,False,99,100,27,1,26
4644,False,20,21,11,0,11
4645,False,49,50,41,1,40
4646,False,32,33,73,2,71
4647,False,162,163,79,2,77
4648,False,42,43,18,0,18
4649,False,24,25,24,0,24
4650,False,44,45,30,0,30
4651,False,161,162,117,3,114
4652,False,46,47,21,0,21
4653,False,93,94,27,0,27
4654,False,36,37,8,2,6
4655,False,63,64,39,0,39
4656,False,30,31,26,0,26
4657,False,25,26,17,0,17
4658,False,135,136,133,3,130
4659,False,44,45,27,0,27
4660,False,51,52,31,0,31
4661,False,22,23,16,0,16
4662,False,66,67,71,1,70
4663,False,22,23,27,0,27
4664,False,2,3,1,0,1
4665,False,25,26,21,1,20
4666,False,31,32,15,0,15
4667,False,8,9,7,1,6
4668,False,20,21,12,0,12
4669,False,94,95,84,0,84
4670,False,44,45,40,0,40
4671,False,6,7,1,0,1
4672,False,19,20,5,0,5
4673,False,20,21,54,1,53
4674,False,13,14,47,1,46
4675,False,6,7,43,0,43
4676,False,51,52,79,3,76
4677,False,10,11,30,0,30
4678,False,31,32,17,0,17
4679,False,47,48,65,0,65
4680,False,68,69,41,0,41
4681,False,41,42,42,1,41
4682,False,2,3,3,0,3
4683,False,28,29,15,0,15
4684,False,49,50,110,1,109
4685,False,136,137,155,1,154
4686,False,41,42,35,0,35
4687,False,25,26,6,0,6
4688,False,96,97,56,1,55
4689,False,18,19,17,0,17
4690,False,149,150,128,0,128
4691,False,20,21,61,0,61
4692,False,15,16,77,0,77
4693,False,48,49,38,0,38
4694,False,47,48,50,0,50
4695,False,66,67,17,2,15
4696,False,37,38,51,0,51
4697,False,28,29,103,0,103
4698,False,28,29,14,0,14
4699,False,51,52,30,0,30
4700,False,32,33,24,0,24
4701,False,36,37,43,0,43
4702,False,24,25,3,1,2
4703,False,11,12,2,1,1
4704,False,17,18,17,0,17
4705,False,51,52,11,0,11
4706,False,83,84,53,11,42
4707,False,34,35,26,0,26
4708,False,57,58,44,0,44
4709,False,47,48,38,1,37
4710,False,40,41,53,1,52
4711,False,208,209,157,2,155
4712,False,15,16,18,0,18
4713,False,37,38,44,0,44
4714,False,7,8,16,0,16
4715,False,11,12,5,1,4
4716,False,54,55,28,13,15
4717,False,46,47,26,0,26
4718,False,59,60,18,0,18
4719,False,13,14,3,0,3
4720,False,17,18,12,1,11
4721,False,44,45,61,0,61
4722,False,48,49,37,0,37
4723,False,44,45,19,1,18
4724,False,56,57,53,0,53
4725,False,37,38,12,2,10
4726,False,21,22,49,1,48
4727,False,23,24,17,0,17
4728,False,106,107,75,1,74
4729,False,95,96,23,0,23
4730,False,40,41,22,0,22
4731,False,49,50,73,1,72
4732,False,36,37,22,0,22
4733,False,23,24,21,0,21
4734,False,58,59,52,0,52
4735,False,47,48,26,1,25
4736,False,40,41,14,0,14
4737,False,31,32,31,1,30
4738,False,36,37,58,1,57
4739,False,50,51,1,0,1
4740,False,17,18,0,0,0
4741,False,19,20,20,1,19
4742,False,21,22,13,0,13
4743,False,55,56,44,0,44
4744,False,22,23,18,0,18
4745,False,5,6,2,0,2
4746,False,94,95,57,0,57
4747,False,30,31,27,1,26
4748,False,19,20,59,2,57
4749,False,33,34,66,0,66
4750,False,44,45,44,1,43
4751,False,24,25,21,0,21
4752,False,67,68,47,3,44
4753,False,21,22,18,0,18
4754,False,37,38,23,0,23
4755,False,82,83,110,2,108
4756,False,4,5,4,0,4
4757,False,13,14,27,3,24
4758,False,55,56,35,0,35
4759,False,39,40,47,0,47
4760,False,52,53,45,3,42
4761,False,24,25,30,0,30
4762,False,16,17,10,0,10
4763,False,23,24,82,0,82
4764,False,40,41,55,1,54
4765,False,24,25,19,1,18
4766,False,66,67,37,0,37
4767,False,21,22,39,0,39
4768,False,27,28,12,1,11
4769,False,21,22,7,0,7
4770,False,26,27,65,0,65
4771,False,53,54,13,2,11
4772,False,41,42,23,0,23
4773,False,50,51,56,1,55
4774,False,33,34,19,0,19
4775,False,33,34,18,0,18
4776,False,16,17,18,0,18
4777,False,38,39,37,2,35
4778,False,24,25,57,0,57
4779,False,19,20,6,0,6
4780,False,36,37,21,0,21
4781,False,34,35,60,0,60
4782,False,39,40,18,0,18
4783,False,31,32,21,0,21
4784,False,30,31,30,0,30
4785,False,32,33,73,1,72
4786,False,15,16,9,0,9
4787,False,30,31,11,0,11
4788,False,54,55,74,1,73
4789,False,42,43,44,2,42
4790,False,94,95,77,2,75
4791,False,22,23,9,0,9
4792,False,7,8,11,1,10
4793,False,56,57,50,1,49
4794,False,48,49,30,0,30
4795,False,66,67,40,2,38
4796,False,39,40,46,0,46
4797,False,52,53,66,1,65
4798,False,32,33,36,0,36
4799,False,27,28,24,0,24
4800,False,70,71,37,0,37
4801,False,11,12,1,1,0
4802,False,28,29,18,0,18
4803,False,12,13,1,0,1
4804,False,49,50,30,1,29
4805,False,5,6,3,0,3
4806,False,4,5,1,0,1
4807,False,8,9,28,0,28
4808,False,7,8,8,0,8
4809,False,16,17,14,1,13
4810,False,33,34,12,0,12
4811,False,33,34,48,0,48
4812,False,9,10,2,0,2
4813,False,13,14,5,1,4
4814,False,23,24,35,0,35
4815,False,24,25,15,0,15
4816,False,23,24,17,0,17
4817,False,28,29,18,0,18
4818,False,19,20,37,2,35
4819,False,75,76,32,0,32
4820,False,9,10,15,0,15
4821,False,18,19,10,0,10
4822,False,79,80,84,1,83
4823,False,12,13,4,0,4
4824,False,43,44,64,0,64
4825,False,40,41,25,0,25
4826,False,34,35,11,1,10
4827,False,127,128,95,0,95
4828,False,45,46,40,1,39
4829,False,40,41,16,0,16
4830,False,13,14,3,0,3
4831,False,23,24,33,0,33
4832,False,4,5,9,1,8
4833,False,57,58,82,1,81
4834,False,41,42,25,0,25
4835,False,56,57,45,0,45
4836,False,18,19,36,0,36
4837,False,30,31,10,0,10
4838,False,17,18,8,0,8
4839,False,59,60,28,0,28
4840,False,1,2,2,0,2
4841,False,46,47,47,5,42
4842,False,2,3,1,0,1
4843,False,33,34,32,0,32
4844,False,117,118,55,0,55
4845,False,6,7,39,0,39
4846,False,44,45,26,0,26
4847,False,13,14,7,0,7
4848,False,8,9,5,0,5
4849,False,17,18,6,0,6
4850,False,15,16,13,0,13
4851,False,35,36,30,0,30
4852,False,43,44,24,0,24
4853,False,54,55,35,0,35
4854,False,8,9,5,0,5
4855,False,32,33,23,1,22
4856,False,56,57,68,0,68
4857,False,16,17,2,0,2
4858,False,101,102,102,1,101
4859,False,66,67,68,0,68
4860,False,19,20,16,0,16
4861,False,29,30,15,0,15
4862,False,31,32,14,0,14
4863,False,56,57,108,0,108
4864,False,40,41,53,1,52
4865,False,53,54,38,0,38
4866,False,108,109,89,2,87
4867,False,35,36,58,0,58
4868,False,13,14,14,0,14
4869,False,39,40,56,0,56
4870,False,31,32,24,0,24
4871,False,34,35,32,0,32
4872,False,81,82,94,1,93
4873,False,15,16,12,0,12
4874,False,88,89,90,17,73
4875,False,23,24,37,0,37
4876,False,14,15,5,0,5
4877,False,82,83,43,2,41
4878,False,22,23,13,0,13
4879,False,34,35,36,0,36
4880,False,29,30,27,4,23
4881,False,28,29,19,3,16
4882,False,29,30,39,0,39
4883,False,33,34,20,1,19
4884,False,24,25,52,1,51
4885,False,32,33,14,0,14
4886,False,81,82,49,0,49
4887,False,33,34,58,0,58
4888,False,16,17,16,0,16
4889,False,14,15,3,1,2
4890,False,24,25,8,0,8
4891,False,40,41,47,0,47
4892,False,45,46,30,0,30
4893,False,20,21,38,0,38
4894,False,4,5,13,2,11
4895,False,14,15,33,0,33
4896,False,44,45,16,0,16
4897,False,30,31,14,0,14
4898,False,34,35,68,1,67
4899,False,38,39,10,0,10
4900,False,34,35,37,0,37
4901,False,22,23,31,0,31
4902,False,36,37,50,1,49
4903,False,11,12,13,0,13
4904,False,17,18,29,0,29
4905,False,15,16,6,1,5
4906,False,40,41,10,1,9
4907,False,53,54,18,2,16
4908,False,22,23,10,0,10
4909,False,102,103,85,0,85
4910,False,31,32,31,0,31
4911,False,21,22,16,0,16
4912,False,65,66,16,0,16
4913,False,43,44,52,2,50
4914,False,24,25,16,1,15
4915,False,46,47,58,1,57
4916,False,17,18,24,1,23
4917,False,31,32,13,0,13
4918,False,21,22,17,0,17
4919,False,38,39,34,0,34
4920,False,8,9,2,1,1
4921,False,20,21,18,2,16
4922,False,16,17,8,0,8
4923,False,34,35,37,0,37
4924,False,38,39,21,0,21
4925,False,27,28,14,1,13
4926,False,26,27,13,0,13
4927,False,38,39,49,1,48
4928,False,27,28,35,0,35
4929,False,4,5,3,0,3
4930,False,71,72,46,4,42
4931,False,36,37,38,0,38
4932,False,20,21,8,1,7
4933,False,31,32,13,0,13
4934,False,60,61,35,0,35
4935,False,62,63,63,10,53
4936,False,27,28,38,0,38
4937,False,16,17,12,1,11
4938,False,33,34,43,2,41
4939,False,11,12,4,0,4
4940,False,6,7,6,0,6
4941,False,16,17,61,0,61
4942,False,48,49,54,0,54
4943,False,43,44,28,1,27
4944,False,6,7,8,0,8
4945,False,54,55,37,1,36
4946,False,71,72,65,6,59
4947,False,18,19,19,1,18
4948,False,5,6,29,0,29
4949,False,26,27,20,3,17
4950,False,50,51,50,0,50
4951,False,11,12,27,0,27
4952,False,39,40,76,0,76
4953,False,48,49,13,0,13
4954,False,38,39,20,0,20
4955,False,57,58,83,0,83
4956,False,9,10,3,0,3
4957,False,24,25,15,0,15
4958,False,29,30,69,0,69
4959,False,52,53,16,2,14
4960,False,42,43,14,0,14
4961,False,42,43,29,0,29
4962,False,20,21,12,0,12
4963,False,12,13,1,0,1
4964,False,78,79,42,1,41
4965,False,100,101,68,0,68
4966,False,32,33,26,0,26
4967,False,11,12,40,2,38
4968,False,13,14,10,0,10
4969,False,21,22,21,0,21
4970,False,33,34,42,1,41
4971,False,11,12,7,2,5
4972,False,25,26,41,1,40
4973,False,33,34,23,0,23
4974,False,14,15,3,0,3
4975,False,36,37,22,0,22
4976,False,137,138,78,2,76
4977,False,53,54,81,2,79
4978,False,16,17,4,0,4
4979,False,11,12,5,0,5
4980,False,56,57,61,1,60
4981,False,41,42,36,2,34
4982,False,11,12,6,1,5
4983,False,39,40,50,0,50
4984,False,44,45,19,0,19
4985,False,35,36,10,1,9
4986,False,15,16,9,1,8
4987,False,21,22,25,0,25
4988,False,20,21,41,2,39
4989,False,4,5,7,0,7
4990,False,25,26,81,0,81
4991,False,21,22,20,0,20
4992,False,56,57,76,0,76
4993,False,35,36,43,0,43
4994,False,62,63,37,2,35
4995,False,29,30,35,1,34
4996,False,72,73,51,0,51
4997,False,14,15,13,0,13
4998,False,27,28,30,0,30
4999,False,53,54,52,1,51
5000,False,110,111,76,0,76
5001,False,9,10,9,4,5
5002,False,11,12,34,0,34
5003,False,72,73,69,1,68
5004,False,36,37,38,2,36
5005,False,18,19,15,0,15
5006,False,79,80,55,0,55
5007,False,38,39,76,0,76
5008,False,31,32,16,0,16
5009,False,44,45,34,0,34
5010,False,13,14,4,0,4
5011,False,85,86,39,1,38
5012,False,111,112,70,0,70
5013,False,12,13,15,0,15
5014,False,58,59,26,1,25
5015,False,33,34,49,0,49
5016,False,44,45,24,0,24
5017,False,92,93,57,0,57
5018,False,18,19,38,0,38
5019,False,30,31,61,2,59
5020,False,11,12,8,1,7
5021,False,16,17,1,0,1
5022,False,58,59,53,0,53
5023,False,51,52,71,0,71
5024,False,7,8,8,0,8
5025,False,37,38,28,0,28
5026,False,43,44,19,0,19
5027,False,56,57,31,0,31
5028,False,49,50,50,2,48
5029,False,70,71,47,1,46
5030,False,50,51,43,0,43
5031,False,10,11,8,0,8
5032,False,24,25,4,0,4
5033,False,64,65,32,0,32
5034,False,52,53,42,0,42
5035,False,39,40,20,0,20
5036,False,12,13,13,0,13
5037,False,16,17,3,1,2
5038,False,15,16,42,0,42
5039,False,61,62,58,0,58
5040,False,33,34,11,0,11
5041,False,38,39,12,0,12
5042,False,38,39,22,0,22
5043,False,6,7,2,0,2
5044,False,55,56,51,1,50
5045,False,63,64,43,0,43
5046,False,50,51,27,0,27
5047,False,31,32,14,0,14
5048,False,18,19,48,0,48
5049,False,28,29,22,0,22
5050,False,16,17,30,0,30
5051,False,21,22,8,0,8
5052,False,65,66,25,0,25
5053,False,23,24,64,0,64
5054,False,33,34,34,0,34
5055,False,8,9,9,0,9
5056,False,67,68,44,0,44
5057,False,58,59,40,0,40
5058,False,28,29,31,0,31
5059,False,33,34,24,0,24
5060,False,45,46,30,0,30
5061,False,27,28,47,0,47
5062,False,16,17,8,0,8
5063,False,19,20,21,0,21
5064,False,42,43,34,1,33
5065,False,51,52,53,1,52
5066,False,22,23,1,0,1
5067,False,117,118,171,3,168
5068,False,60,61,21,1,20
5069,False,23,24,34,0,34
5070,False,13,14,6,1,5
5071,False,20,21,8,0,8
5072,False,15,16,36,0,36
5073,False,11,12,4,1,3
5074,False,32,33,16,0,16
5075,False,34,35,25,0,25
5076,False,62,63,60,2,58
5077,False,30,31,32,2,30
5078,False,42,43,16,0,16
5079,False,9,10,3,0,3
5080,False,52,53,23,0,23
5081,False,15,16,5,0,5
5082,False,35,36,26,0,26
5083,False,4,5,6,0,6
5084,False,14,15,13,1,12
5085,False,28,29,34,0,34
5086,False,22,23,10,0,10
5087,False,21,22,20,1,19
5088,False,87,88,80,0,80
5089,False,55,56,68,0,68
5090,False,28,29,54,0,54
5091,False,14,15,10,0,10
5092,False,80,81,38,0,38
5093,False,96,97,55,0,55
5094,False,33,34,38,0,38
5095,False,32,33,46,0,46
5096,False,10,11,8,0,8
5097,False,4,5,1,0,1
5098,False,29,30,23,0,23
5099,False,34,35,21,0,21
5100,False,26,27,41,1,40
5101,False,29,30,16,0,16
5102,False,39,40,0,0,0
5103,False,18,19,1,0,1
5104,False,4,5,3,0,3
5105,False,16,17,9,0,9
5106,False,27,28,16,0,16
5107,False,29,30,16,1,15
5108,False,59,60,38,0,38
5109,False,9,10,3,0,3
5110,False,50,51,58,0,58
5111,False,12,13,27,11,16
5112,False,10,11,34,1,33
5113,False,19,20,26,3,23
5114,False,32,33,37,0,37
5115,False,51,52,57,0,57
5116,False,49,50,22,0,22
5117,False,46,47,78,0,78
5118,False,16,17,31,0,31
5119,False,11,12,2,0,2
5120,False,55,56,25,0,25
5121,False,38,39,27,0,27
5122,False,20,21,6,0,6
5123,False,12,13,6,0,6
5124,False,63,64,15,0,15
5125,False,99,100,35,0,35
5126,False,15,16,37,1,36
5127,False,61,62,46,0,46
5128,False,37,38,33,1,32
5129,False,55,56,120,0,120
5130,False,22,23,17,1,16
5131,False,21,22,11,0,11
5132,False,13,14,4,1,3
5133,False,40,41,27,0,27
5134,False,48,49,57,1,56
5135,False,8,9,6,0,6
5136,False,28,29,5,2,3
5137,False,16,17,27,0,27
5138,False,69,70,32,0,32
5139,False,36,37,31,1,30
5140,False,21,22,16,1,15
5141,False,21,22,33,0,33
5142,False,79,80,50,2,48
5143,False,10,11,4,0,4
5144,False,9,10,3,0,3
5145,False,36,37,47,1,46
5146,False,135,136,57,6,51
5147,False,82,83,61,0,61
5148,False,18,19,32,0,32
5149,False,25,26,15,0,15
5150,False,10,11,4,0,4
5151,False,85,86,44,2,42
5152,False,14,15,10,0,10
5153,False,16,17,14,0,14
5154,False,45,46,22,0,22
5155,False,31,32,105,3,102
5156,False,37,38,38,1,37
5157,False,13,14,3,2,1
5158,False,37,38,36,0,36
5159,False,17,18,40,0,40
5160,False,30,31,34,1,33
5161,False,25,26,43,1,42
5162,False,13,14,11,4,7
5163,False,35,36,34,1,33
5164,False,43,44,43,0,43
5165,False,20,21,13,0,13
5166,False,17,18,3,0,3
5167,False,19,20,15,0,15
5168,False,9,10,3,0,3
5169,False,19,20,39,3,36
5170,False,67,68,40,3,37
5171,False,38,39,53,1,52
5172,False,22,23,38,0,38
5173,False,7,8,4,0,4
5174,False,18,19,18,0,18
5175,False,34,35,51,0,51
5176,False,30,31,10,0,10
5177,False,3,4,0,0,0
5178,False,15,16,30,0,30
5179,False,58,59,99,0,99
5180,False,16,17,1,0,1
5181,False,39,40,21,0,21
5182,False,45,46,29,0,29
5183,False,111,112,111,0,111
5184,False,71,72,68,5,63
5185,False,35,36,43,0,43
5186,False,53,54,55,0,55
5187,False,30,31,31,0,31
5188,False,37,38,16,0,16
5189,False,44,45,24,0,24
5190,False,64,65,76,0,76
5191,False,64,65,45,1,44
5192,False,13,14,6,0,6
5193,False,14,15,8,0,8
5194,False,48,49,25,1,24
5195,False,13,14,10,0,10
5196,False,73,74,52,2,50
5197,False,26,27,10,0,10
5198,False,29,30,25,2,23
5199,False,22,23,59,2,57
5200,False,23,24,171,0,171
5201,False,33,34,8,1,7
5202,False,50,51,64,1,63
5203,False,6,7,0,0,0
5204,False,11,12,1,0,1
5205,False,13,14,3,0,3
5206,False,8,9,10,0,10
5207,False,43,44,23,1,22
5208,False,48,49,53,1,52
5209,False,70,71,11,0,11
5210,False,8,9,6,0,6
5211,False,95,96,48,0,48
5212,False,18,19,12,0,12
5213,False,14,15,27,0,27
5214,False,71,72,64,0,64
5215,False,64,65,30,0,30
5216,False,70,71,56,0,56
5217,False,38,39,68,1,67
5218,False,23,24,28,0,28
5219,False,51,52,17,0,17
5220,False,35,36,23,6,17
5221,False,46,47,14,0,14
5222,False,58,59,29,1,28
5223,False,69,70,67,1,66
5224,False,131,132,80,1,79
5225,False,60,61,25,0,25
5226,False,11,12,14,0,14
5227,False,15,16,22,0,22
5228,False,36,37,103,1,102
5229,False,42,43,30,0,30
5230,False,19,20,8,0,8
5231,False,37,38,44,0,44
5232,False,35,36,21,0,21
5233,False,101,102,61,1,60
5234,False,58,59,21,2,19
5235,False,26,27,15,0,15
5236,False,70,71,26,2,24
5237,False,27,28,36,0,36
5238,False,38,39,59,1,58
5239,False,133,134,180,6,174
5240,False,14,15,30,0,30
5241,False,21,22,17,0,17
5242,False,40,41,16,0,16
5243,False,37,38,53,0,53
5244,False,39,40,41,0,41
5245,False,46,47,78,0,78
5246,False,30,31,41,0,41
5247,False,40,41,28,0,28
5248,False,51,52,38,1,37
5249,False,26,27,18,0,18
5250,False,42,43,36,1,35
5251,False,17,18,17,0,17
5252,False,24,25,10,0,10
5253,False,11,12,7,0,7
5254,False,10,11,14,0,14
5255,False,18,19,0,0,0
5256,False,32,33,26,0,26
5257,False,20,21,13,0,13
5258,False,37,38,44,0,44
5259,False,15,16,26,1,25
5260,False,8,9,4,0,4
5261,False,34,35,44,1,43
5262,False,31,32,16,0,16
5263,False,34,35,20,0,20
5264,False,5,6,27,2,25
5265,False,112,113,70,0,70
5266,False,42,43,63,0,63
5267,False,19,20,10,0,10
5268,False,21,22,43,0,43
5269,False,53,54,39,0,39
5270,False,38,39,42,0,42
5271,False,25,26,29,1,28
5272,False,47,48,41,1,40
5273,False,35,36,12,0,12
5274,False,31,32,24,0,24
5275,False,11,12,6,4,2
5276,False,72,73,27,0,27
5277,False,9,10,4,3,1
5278,False,15,16,0,0,0
5279,False,67,68,65,4,61
5280,False,23,24,37,1,36
5281,False,9,10,5,1,4
5282,False,30,31,10,0,10
5283,False,4,5,15,0,15
5284,False,44,45,30,0,30
5285,False,37,38,22,0,22
5286,False,29,30,19,0,19
5287,False,14,15,27,0,27
5288,False,32,33,20,0,20
5289,False,10,11,57,0,57
5290,False,31,32,18,0,18
5291,False,49,50,39,1,38
5292,False,63,64,62,1,61
5293,False,68,69,96,2,94
5294,False,38,39,21,0,21
5295,False,54,55,122,2,120
5296,False,8,9,1,1,0
5297,False,16,17,16,1,15
5298,False,9,10,52,0,52
5299,False,36,37,35,0,35
5300,False,85,86,55,4,51
5301,False,25,26,29,1,28
5302,False,19,20,14,0,14
5303,False,62,63,55,7,48
5304,False,62,63,73,0,73
5305,False,47,48,62,0,62
5306,False,10,11,17,0,17
5307,False,50,51,30,0,30
5308,False,3,4,8,0,8
5309,False,10,11,58,0,58
5310,False,26,27,45,0,45
5311,False,12,13,36,0,36
5312,False,26,27,14,0,14
5313,False,35,36,18,0,18
5314,False,87,88,47,1,46
5315,False,31,32,45,0,45
5316,False,30,31,37,0,37
5317,False,44,45,18,0,18
5318,False,38,39,38,0,38
5319,False,23,24,25,0,25
5320,False,46,47,34,0,34
5321,False,73,74,51,0,51
5322,False,79,80,94,10,84
5323,False,42,43,25,0,25
5324,False,44,45,52,0,52
5325,False,18,19,34,0,34
5326,False,28,29,21,0,21
5327,False,30,31,20,0,20
5328,False,49,50,27,2,25
5329,False,17,18,36,0,36
5330,False,50,51,54,2,52
5331,False,29,30,66,0,66
5332,False,25,26,11,0,11
5333,False,23,24,15,1,14
5334,False,9,10,11,1,10
5335,False,21,22,19,0,19
5336,False,364,365,301,5,296
5337,False,59,60,65,0,65
5338,False,23,24,16,0,16
5339,False,33,34,41,0,41
5340,False,53,54,106,2,104
5341,False,32,33,19,0,19
5342,False,45,46,64,1,63
5343,False,82,83,74,2,72
5344,False,17,18,7,1,6
5345,False,50,51,40,2,38
5346,False,50,51,38,0,38
5347,False,36,37,9,0,9
5348,False,12,13,5,2,3
5349,False,57,58,72,0,72
5350,False,51,52,30,0,30
5351,False,35,36,28,0,28
5352,False,56,57,19,0,19
5353,False,15,16,68,0,68
5354,False,41,42,98,0,98
5355,False,83,84,82,1,81
5356,False,44,45,45,1,44
5357,False,103,104,55,5,50
5358,False,6,7,7,0,7
5359,False,25,26,20,1,19
5360,False,5,6,6,0,6
5361,False,11,12,14,0,14
5362,False,53,54,43,0,43
5363,False,30,31,29,0,29
5364,False,94,95,60,0,60
5365,False,31,32,21,1,20
5366,False,46,47,68,3,65
5367,False,29,30,20,0,20
5368,False,15,16,8,0,8
5369,False,14,15,2,1,1
5370,False,33,34,78,2,76
5371,False,47,48,75,3,72
5372,False,58,59,22,1,21
5373,False,85,86,124,5,119
5374,False,32,33,42,3,39
5375,False,37,38,46,1,45
5376,False,112,113,61,0,61
5377,False,37,38,7,0,7
5378,False,21,22,15,0,15
5379,False,27,28,17,0,17
5380,False,17,18,19,0,19
5381,False,36,37,40,0,40
5382,False,18,19,11,0,11
5383,False,11,12,11,3,8
5384,False,134,135,47,0,47
5385,False,24,25,37,1,36
5386,False,11,12,34,0,34
5387,False,25,26,13,0,13
5388,False,17,18,6,0,6
5389,False,114,115,57,0,57
5390,False,62,63,53,3,50
5391,False,12,13,23,1,22
5392,False,34,35,26,0,26
5393,False,49,50,51,1,50
5394,False,62,63,68,0,68
5395,False,52,53,44,1,43
5396,False,10,11,11,0,11
5397,False,19,20,35,0,35
5398,False,5,6,21,0,21
5399,False,106,107,72,1,71
5400,False,51,52,54,0,54
5401,False,19,20,22,0,22
5402,False,38,39,23,0,23
5403,False,5,6,3,0,3
5404,False,75,76,15,1,14
5405,False,41,42,20,0,20
5406,False,8,9,12,1,11
5407,False,17,18,47,0,47
5408,False,26,27,10,0,10
5409,False,9,10,7,0,7
5410,False,39,40,41,0,41
5411,False,9,10,0,0,0
5412,False,31,32,39,1,38
5413,False,23,24,8,0,8
5414,False,28,29,37,0,37
5415,False,33,34,13,0,13
5416,False,42,43,37,1,36
5417,False,47,48,19,0,19
5418,False,41,42,26,0,26
5419,False,43,44,41,0,41
5420,False,14,15,8,0,8
5421,False,19,20,28,1,27
5422,False,48,49,61,1,60
5423,False,16,17,34,0,34
5424,False,92,93,112,2,110
5425,False,34,35,24,3,21
5426,False,27,28,18,0,18
5427,False,61,62,77,2,75
5428,False,28,29,31,1,30
5429,False,48,49,26,0,26
5430,False,20,21,18,1,17
5431,False,43,44,22,0,22
5432,False,51,52,31,1,30
5433,False,2,3,0,0,0
5434,False,48,49,67,2,65
5435,False,60,61,19,1,18
5436,False,11,12,0,0,0
5437,False,8,9,9,0,9
5438,False,27,28,13,1,12
5439,False,35,36,92,0,92
5440,False,57,58,30,1,29
5441,False,62,63,44,0,44
5442,False,39,40,24,1,23
5443,False,12,13,29,1,28
5444,False,16,17,20,0,20
5445,False,39,40,20,1,19
5446,False,32,33,22,0,22
5447,False,75,76,60,0,60
5448,False,41,42,23,0,23
5449,False,52,53,51,1,50
5450,False,5,6,3,1,2
5451,False,34,35,20,0,20
5452,False,39,40,50,0,50
5453,False,26,27,15,0,15
5454,False,7,8,4,0,4
5455,False,68,69,48,1,47
5456,False,23,24,8,0,8
5457,False,50,51,17,1,16
5458,False,38,39,60,1,59
5459,False,52,53,48,0,48
5460,False,19,20,17,0,17
5461,False,27,28,11,0,11
5462,False,38,39,26,0,26
5463,False,44,45,83,0,83
5464,False,49,50,21,0,21
5465,False,16,17,6,0,6
5466,False,28,29,14,0,14
5467,False,18,19,17,0,17
5468,False,6,7,8,3,5
5469,False,74,75,65,0,65
5470,False,25,26,30,0,30
5471,False,45,46,25,0,25
5472,False,50,51,39,0,39
5473,False,20,21,46,0,46
5474,False,20,21,34,0,34
5475,False,37,38,13,0,13
5476,False,59,60,25,3,22
5477,False,10,11,1,0,1
5478,False,35,36,38,2,36
5479,False,17,18,12,0,12
5480,False,27,28,14,0,14
5481,False,29,30,31,0,31
5482,False,54,55,24,1,23
5483,False,24,25,11,0,11
5484,False,22,23,9,1,8
5485,False,66,67,48,0,48
5486,False,31,32,13,0,13
5487,False,59,60,34,0,34
5488,False,39,40,46,0,46
5489,False,5,6,1,0,1
5490,False,19,20,14,1,13
5491,False,12,13,27,11,16
5492,False,26,27,14,1,13
5493,False,127,128,60,1,59
5494,False,46,47,35,2,33
5495,False,30,31,56,0,56
5496,False,62,63,21,4,17
5497,False,28,29,38,1,37
5498,False,44,45,46,2,44
5499,False,28,29,39,0,39
5500,False,56,57,25,3,22
5501,False,7,8,33,0,33
5502,False,12,13,20,1,19
5503,False,16,17,55,0,55
5504,False,25,26,33,0,33
5505,False,18,19,89,1,88
5506,False,11,12,15,0,15
5507,False,18,19,10,0,10
5508,False,51,52,89,0,89
5509,False,33,34,21,0,21
5510,False,19,20,42,0,42
5511,False,10,11,18,0,18
5512,False,22,23,17,0,17
5513,False,4,5,3,0,3
5514,False,2,3,0,0,0
5515,False,31,32,35,0,35
5516,False,17,18,34,0,34
5517,False,32,33,41,0,41
5518,False,66,67,52,0,52
5519,False,43,44,55,0,55
5520,False,15,16,5,0,5
5521,False,34,35,19,0,19
5522,False,43,44,24,2,22
5523,False,22,23,46,1,45
5524,False,15,16,17,1,16
5525,False,52,53,61,0,61
5526,False,41,42,28,0,28
5527,False,22,23,36,0,36
5528,False,8,9,50,0,50
5529,False,15,16,39,0,39
5530,False,20,21,11,0,11
5531,False,99,100,97,0,97
5532,False,54,55,29,0,29
5533,False,44,45,36,0,36
5534,False,77,78,65,3,62
5535,False,54,55,29,2,27
5536,False,112,113,69,6,63
5537,False,18,19,18,0,18
5538,False,31,32,17,0,17
5539,False,20,21,15,0,15
5540,False,10,11,4,0,4
5541,False,32,33,14,0,14
5542,False,27,28,51,0,51
5543,False,28,29,44,1,43
5544,False,35,36,23,1,22
5545,False,45,46,54,0,54
5546,False,29,30,48,1,47
5547,False,44,45,26,0,26
5548,False,55,56,23,0,23
5549,False,50,51,37,2,35
5550,False,20,21,12,0,12
5551,False,76,77,75,0,75
5552,False,41,42,56,3,53
5553,False,44,45,17,0,17
5554,False,19,20,12,0,12
5555,False,32,33,61,1,60
5556,False,68,69,38,5,33
5557,False,65,66,33,1,32
5558,False,48,49,94,3,91
5559,False,23,24,13,0,13
5560,False,70,71,90,4,86
5561,False,23,24,36,1,35
5562,False,21,22,21,0,21
5563,False,21,22,71,0,71
5564,False,33,34,6,0,6
5565,False,47,48,94,1,93
5566,False,50,51,29,1,28
5567,False,29,30,31,1,30
5568,False,25,26,6,0,6
5569,False,29,30,18,1,17
5570,False,21,22,58,0,58
5571,False,20,21,26,1,25
5572,False,22,23,15,0,15
5573,False,30,31,41,2,39
5574,False,31,32,40,0,40
5575,False,45,46,16,0,16
5576,False,14,15,3,0,3
5577,False,5,6,2,0,2
5578,False,23,24,37,0,37
5579,False,22,23,31,0,31
5580,False,34,35,22,0,22
5581,False,31,32,80,1,79
5582,False,44,45,28,0,28
5583,False,37,38,70,1,69
5584,False,20,21,2,0,2
5585,False,10,11,1,0,1
5586,False,13,14,41,0,41
5587,False,9,10,4,0,4
5588,False,12,13,13,0,13
5589,False,13,14,51,0,51
5590,False,68,69,71,1,70
5591,False,17,18,14,1,13
5592,False,21,22,6,1,5
5593,False,27,28,35,0,35
5594,False,14,15,8,0,8
5595,False,57,58,39,1,38
5596,False,18,19,55,1,54
5597,False,46,47,63,0,63
5598,False,26,27,6,0,6
5599,False,54,55,21,0,21
5600,False,10,11,5,0,5
5601,False,10,11,2,0,2
5602,False,82,83,84,1,83
5603,False,51,52,44,0,44
5604,False,25,26,24,0,24
5605,False,23,24,12,0,12
5606,False,23,24,37,0,37
5607,False,42,43,39,0,39
5608,False,21,22,13,0,13
5609,False,33,34,16,0,16
5610,False,32,33,36,0,36
5611,False,11,12,2,0,2
5612,False,44,45,14,0,14
5613,False,15,16,4,0,4
5614,False,37,38,26,0,26
5615,False,101,102,115,4,111
5616,False,45,46,47,2,45
5617,False,30,31,21,0,21
5618,False,15,16,16,0,16
5619,False,30,31,34,0,34
5620,False,29,30,38,0,38
5621,False,25,26,23,0,23
5622,False,27,28,25,1,24
5623,False,27,28,48,1,47
5624,False,51,52,38,0,38
5625,False,46,47,36,0,36
5626,False,34,35,24,1,23
5627,False,41,42,41,0,41
5628,False,37,38,28,0,28
5629,False,8,9,7,0,7
5630,False,44,45,22,0,22
5631,False,9,10,9,0,9
5632,False,102,103,74,0,74
5633,False,37,38,30,0,30
5634,False,32,33,17,0,17
5635,False,7,8,3,0,3
5636,False,45,46,55,0,55
5637,False,4,5,40,1,39
5638,False,14,15,10,0,10
5639,False,15,16,15,1,14
5640,False,26,27,20,2,18
5641,False,30,31,36,0,36
5642,False,21,22,3,0,3
5643,False,24,25,18,0,18
5644,False,15,16,3,1,2
5645,False,8,9,8,0,8
5646,False,21,22,11,0,11
5647,False,29,30,5,1,4
5648,False,21,22,9,0,9
5649,False,31,32,26,1,25
5650,False,29,30,21,0,21
5651,False,118,119,85,0,85
5652,False,116,117,57,6,51
5653,False,63,64,21,0,21
5654,False,20,21,14,0,14
5655,False,35,36,65,0,65
5656,False,59,60,57,0,57
5657,False,17,18,25,0,25
5658,False,27,28,32,4,28
5659,False,12,13,2,1,1
5660,False,107,108,67,0,67
5661,False,26,27,15,0,15
5662,False,36,37,26,0,26
5663,False,48,49,43,3,40
5664,False,29,30,44,0,44
5665,False,7,8,4,0,4
5666,False,100,101,108,6,102
5667,False,27,28,30,0,30
5668,False,12,13,7,0,7
5669,False,21,22,61,0,61
5670,False,29,30,20,0,20
5671,False,30,31,21,0,21
5672,False,27,28,19,0,19
5673,False,9,10,6,2,4
5674,False,34,35,43,1,42
5675,False,57,58,77,1,76
5676,False,68,69,65,0,65
5677,False,121,122,94,0,94
5678,False,11,12,26,0,26
5679,False,11,12,3,0,3
5680,False,27,28,26,0,26
5681,False,29,30,52,0,52
5682,False,18,19,78,1,77
5683,False,20,21,7,0,7
5684,False,14,15,4,0,4
5685,False,65,66,48,0,48
5686,False,42,43,32,1,31
5687,False,8,9,6,0,6
5688,False,10,11,19,0,19
5689,False,3,4,2,0,2
5690,False,37,38,20,0,20
5691,False,4,5,6,0,6
5692,False,24,25,17,0,17
5693,False,6,7,3,0,3
5694,False,10,11,3,0,3
5695,False,4,5,6,0,6
5696,False,36,37,44,0,44
5697,False,25,26,38,0,38
5698,False,11,12,18,0,18
5699,False,71,72,64,0,64
5700,False,32,33,35,0,35
5701,False,41,42,46,0,46
5702,False,61,62,71,1,70
5703,False,47,48,33,6,27
5704,False,19,20,55,0,55
5705,False,47,48,30,0,30
5706,False,38,39,25,0,25
5707,False,26,27,17,0,17
5708,False,14,15,27,2,25
5709,False,19,20,42,2,40
5710,False,39,40,28,0,28
5711,False,14,15,9,0,9
5712,False,79,80,32,2,30
5713,False,10,11,11,0,11
5714,False,18,19,35,2,33
5715,False,44,45,19,0,19
5716,False,65,66,17,1,16
5717,False,39,40,42,1,41
5718,False,38,39,28,0,28
5719,False,22,23,33,4,29
5720,False,20,21,12,0,12
5721,False,61,62,33,3,30
5722,False,57,58,39,5,34
5723,False,41,42,27,0,27
5724,False,9,10,9,0,9
5725,False,82,83,75,1,74
5726,False,32,33,52,2,50
5727,False,32,33,44,0,44
5728,False,16,17,10,0,10
5729,False,25,26,14,0,14
5730,False,44,45,69,0,69
5731,False,48,49,116,1,115
5732,False,24,25,12,0,12
5733,False,50,51,33,0,33
5734,False,53,54,37,0,37
5735,False,43,44,22,0,22
5736,False,13,14,9,0,9
5737,False,57,58,26,1,25
5738,False,7,8,6,0,6
5739,False,55,56,51,2,49
5740,False,36,37,16,0,16
5741,False,32,33,33,2,31
5742,False,19,20,26,2,24
5743,False,16,17,63,2,61
5744,False,48,49,35,0,35
5745,False,18,19,19,0,19
5746,False,45,46,74,0,74
5747,False,52,53,28,2,26
5748,False,9,10,5,1,4
5749,False,34,35,19,0,19
5750,False,25,26,34,0,34
5751,False,60,61,56,1,55
5752,False,15,16,0,0,0
5753,False,31,32,4,0,4
5754,False,27,28,24,1,23
5755,False,21,22,60,0,60
5756,False,52,53,56,0,56
5757,False,81,82,55,5,50
5758,False,51,52,3,0,3
5759,False,17,18,0,0,0
5760,False,15,16,17,0,17
5761,False,38,39,16,0,16
5762,False,38,39,46,0,46
5763,False,18,19,16,0,16
5764,False,17,18,11,0,11
5765,False,83,84,24,1,23
5766,False,10,11,3,0,3
5767,False,18,19,17,0,17
5768,False,33,34,41,0,41
5769,False,31,32,59,0,59
5770,False,1,2,0,0,0
5771,False,38,39,40,0,40
5772,False,41,42,60,1,59
5773,False,11,12,5,0,5
5774,False,99,100,64,1,63
5775,False,38,39,17,0,17
5776,False,12,13,6,0,6
5777,False,10,11,3,1,2
5778,False,13,14,7,0,7
5779,False,48,49,44,0,44
5780,False,23,24,26,1,25
5781,False,27,28,82,0,82
5782,False,69,70,60,1,59
5783,False,8,9,2,1,1
5784,False,31,32,82,1,81
5785,False,45,46,56,0,56
5786,False,7,8,1,0,1
5787,False,22,23,16,0,16
5788,False,52,53,43,0,43
5789,False,19,20,11,0,11
5790,False,25,26,16,1,15
5791,False,52,53,32,1,31
5792,False,65,66,47,3,44
5793,False,33,34,30,0,30
5794,False,48,49,27,1,26
5795,False,39,40,56,1,55
5796,False,29,30,19,0,19
5797,False,32,33,85,5,80
5798,False,33,34,59,1,58
5799,False,22,23,43,0,43
5800,False,33,34,41,1,40
5801,False,14,15,15,0,15
5802,False,54,55,93,0,93
5803,False,40,41,38,0,38
5804,False,78,79,81,1,80
5805,False,90,91,84,1,83
5806,False,46,47,17,0,17
5807,False,41,42,59,1,58
5808,False,15,16,14,0,14
5809,False,25,26,77,0,77
5810,False,33,34,115,1,114
5811,False,74,75,61,0,61
5812,False,45,46,37,0,37
5813,False,23,24,10,0,10
5814,False,29,30,35,1,34
5815,False,20,21,11,0,11
5816,False,14,15,1,0,1
5817,False,8,9,4,1,3
5818,False,17,18,88,2,86
5819,False,25,26,49,0,49
5820,False,30,31,41,0,41
5821,False,67,68,24,0,24
5822,False,24,25,12,0,12
5823,False,57,58,80,2,78
5824,False,11,12,6,0,6
5825,False,41,42,40,1,39
5826,False,31,32,43,1,42
5827,False,16,17,9,0,9
5828,False,26,27,5,0,5
5829,False,34,35,44,1,43
5830,False,44,45,85,1,84
5831,False,23,24,5,0,5
5832,False,6,7,1,0,1
5833,False,23,24,15,0,15
5834,False,34,35,16,0,16
5835,False,11,12,24,7,17
5836,False,26,27,31,0,31
5837,False,44,45,55,1,54
5838,False,16,17,29,1,28
5839,False,40,41,29,0,29
5840,False,54,55,48,0,48
5841,False,13,14,36,0,36
5842,False,14,15,15,0,15
5843,False,29,30,19,0,19
5844,False,10,11,9,0,9
5845,False,33,34,41,0,41
5846,False,15,16,14,0,14
5847,False,81,82,42,0,42
5848,False,65,66,59,0,59
5849,False,23,24,15,1,14
5850,False,37,38,21,0,21
5851,False,17,18,32,0,32
5852,False,39,40,9,0,9
5853,False,38,39,24,0,24
5854,False,21,22,10,0,10
5855,False,42,43,34,0,34
5856,False,14,15,9,0,9
5857,False,18,19,5,1,4
5858,False,39,40,31,0,31
5859,False,24,25,9,0,9
5860,False,17,18,10,2,8
5861,False,14,15,20,1,19
5862,False,20,21,70,2,68
5863,False,50,51,23,0,23
5864,False,25,26,24,0,24
5865,False,54,55,20,3,17
5866,False,28,29,18,0,18
5867,False,7,8,5,0,5
5868,False,13,14,41,1,40
5869,False,14,15,33,4,29
5870,False,47,48,88,1,87
5871,False,60,61,21,2,19
5872,False,15,16,31,0,31
5873,False,12,13,3,0,3
5874,False,33,34,33,0,33
5875,False,32,33,51,0,51
5876,False,52,53,19,0,19
5877,False,64,65,46,1,45
5878,False,24,25,41,2,39
5879,False,18,19,10,1,9
5880,False,10,11,6,0,6
5881,False,8,9,1,1,0
5882,False,16,17,23,0,23
5883,False,63,64,53,0,53
5884,False,15,16,14,3,11
5885,False,52,53,4,0,4
5886,False,16,17,1,0,1
5887,False,18,19,15,3,12
5888,False,65,66,29,1,28
5889,False,23,24,27,0,27
5890,False,24,25,31,2,29
5891,False,27,28,17,1,16
5892,False,30,31,83,1,82
5893,False,26,27,40,0,40
5894,False,58,59,71,0,71
5895,False,42,43,17,1,16
5896,False,65,66,92,14,78
5897,False,83,84,80,2,78
5898,False,9,10,5,0,5
5899,False,9,10,3,0,3
5900,False,58,59,57,0,57
5901,False,52,53,20,0,20
5902,False,105,106,72,0,72
5903,False,36,37,51,0,51
5904,False,41,42,34,0,34
5905,False,17,18,5,0,5
5906,False,25,26,16,2,14
5907,False,48,49,20,0,20
5908,False,44,45,45,2,43
5909,False,21,22,21,0,21
5910,False,39,40,64,0,64
5911,False,17,18,25,0,25
5912,False,175,176,133,0,133
5913,False,14,15,6,0,6
5914,False,17,18,5,0,5
5915,False,53,54,76,1,75
5916,False,50,51,2,0,2
5917,False,16,17,0,0,0
5918,False,15,16,12,0,12
5919,False,7,8,2,0,2
5920,False,6,7,2,0,2
5921,False,6,7,3,0,3
5922,False,8,9,1,0,1
5923,False,30,31,21,0,21
5924,False,34,35,45,0,45
5925,False,32,33,40,0,40
5926,False,11,12,8,0,8
5927,False,19,20,7,0,7
5928,False,28,29,17,0,17
5929,False,26,27,20,0,20
5930,False,61,62,26,0,26
5931,False,62,63,57,1,56
5932,False,59,60,75,0,75
5933,False,51,52,43,0,43
5934,False,32,33,20,0,20
5935,False,69,70,32,0,32
5936,False,20,21,22,0,22
5937,False,11,12,5,0,5
5938,False,84,85,104,2,102
5939,False,27,28,11,0,11
5940,False,59,60,19,0,19
5941,False,66,67,63,0,63
5942,False,24,25,17,0,17
5943,False,34,35,59,1,58
5944,False,32,33,33,0,33
5945,False,60,61,46,1,45
5946,False,38,39,49,0,49
5947,False,28,29,40,1,39
5948,False,11,12,45,1,44
5949,False,8,9,15,1,14
5950,False,41,42,50,0,50
5951,False,94,95,92,2,90
5952,False,51,52,47,0,47
5953,False,27,28,10,0,10
5954,False,25,26,17,0,17
5955,False,33,34,30,1,29
5956,False,24,25,15,1,14
5957,False,39,40,45,0,45
5958,False,41,42,36,0,36
5959,False,25,26,9,0,9
5960,False,58,59,81,1,80
5961,False,37,38,22,0,22
5962,False,33,34,58,0,58
5963,False,39,40,28,0,28
5964,False,51,52,96,0,96
5965,False,28,29,48,0,48
5966,False,24,25,13,0,13
5967,False,36,37,24,0,24
5968,False,27,28,16,1,15
5969,False,40,41,20,0,20
5970,False,36,37,54,0,54
5971,False,8,9,33,0,33
5972,False,50,51,26,0,26
5973,False,17,18,32,0,32
5974,False,10,11,5,0,5
5975,False,10,11,5,0,5
5976,False,24,25,19,0,19
5977,False,21,22,23,0,23
5978,False,55,56,42,1,41
5979,False,30,31,68,0,68
5980,False,41,42,52,0,52
5981,False,34,35,43,0,43
5982,False,21,22,11,1,10
5983,False,63,64,49,3,46
5984,False,77,78,56,2,54
5985,False,71,72,100,0,100
5986,False,25,26,18,0,18
5987,False,106,107,63,4,59
5988,False,69,70,44,5,39
5989,False,110,111,118,2,116
5990,False,5,6,6,0,6
5991,False,8,9,9,2,7
5992,False,60,61,92,0,92
5993,False,51,52,42,0,42
5994,False,52,53,76,0,76
5995,False,62,63,42,0,42
5996,False,48,49,25,0,25
5997,False,48,49,58,1,57
5998,False,32,33,25,0,25
5999,False,27,28,12,0,12
6000,False,67,68,79,0,79
6001,False,15,16,28,4,24
6002,False,26,27,15,0,15
6003,False,68,69,63,0,63
6004,False,52,53,45,0,45
6005,False,22,23,15,2,13
6006,False,63,64,22,1,21
6007,False,34,35,20,0,20
6008,False,60,61,33,1,32
6009,False,14,15,14,0,14
6010,False,45,46,82,0,82
6011,False,12,13,0,0,0
6012,False,28,29,25,0,25
6013,False,67,68,61,0,61
6014,False,35,36,35,0,35
6015,False,27,28,8,0,8
6016,False,4,5,0,0,0
6017,False,34,35,13,0,13
6018,False,31,32,39,0,39
6019,False,14,15,4,1,3
6020,False,13,14,12,0,12
6021,False,17,18,40,1,39
6022,False,30,31,20,0,20
6023,False,31,32,18,2,16
6024,False,9,10,9,1,8
6025,False,36,37,59,0,59
6026,False,10,11,8,1,7
6027,False,64,65,37,0,37
6028,False,81,82,55,1,54
6029,False,53,54,68,2,66
6030,False,60,61,68,0,68
6031,False,45,46,36,0,36
6032,False,13,14,33,0,33
6033,False,39,40,31,0,31
6034,False,14,15,15,0,15
6035,False,37,38,22,1,21
6036,False,15,16,27,4,23
6037,False,10,11,13,1,12
6038,False,92,93,76,2,74
6039,False,44,45,12,0,12
6040,False,12,13,2,0,2
6041,False,26,27,12,2,10
6042,False,21,22,10,0,10
6043,False,32,33,56,0,56
6044,False,20,21,28,0,28
6045,False,58,59,76,0,76
6046,False,26,27,24,1,23
6047,False,31,32,27,0,27
6048,False,181,182,118,0,118
6049,False,8,9,6,0,6
6050,False,11,12,0,0,0
6051,False,49,50,48,0,48
6052,False,22,23,27,0,27
6053,False,11,12,17,0,17
6054,False,10,11,30,1,29
6055,False,38,39,23,0,23
6056,False,61,62,36,0,36
6057,False,49,50,32,0,32
6058,False,50,51,66,1,65
6059,False,5,6,30,1,29
6060,False,15,16,17,0,17
6061,False,28,29,13,1,12
6062,False,22,23,43,1,42
6063,False,34,35,43,0,43
6064,False,20,21,35,0,35
6065,False,27,28,50,0,50
6066,False,16,17,56,0,56
6067,False,29,30,19,0,19
6068,False,37,38,9,0,9
6069,False,42,43,41,0,41
6070,False,24,25,100,1,99
6071,False,8,9,34,0,34
6072,False,11,12,1,0,1
6073,False,7,8,7,0,7
6074,False,12,13,6,0,6
6075,False,35,36,17,0,17
6076,False,51,52,50,0,50
6077,False,20,21,7,2,5
6078,False,27,28,10,1,9
6079,False,10,11,27,7,20
6080,False,35,36,30,0,30
6081,False,45,46,53,0,53
6082,False,20,21,35,0,35
6083,False,44,45,25,2,23
6084,False,74,75,51,6,45
6085,False,23,24,55,0,55
6086,False,43,44,59,1,58
6087,False,46,47,68,1,67
6088,False,46,47,32,0,32
6089,False,38,39,89,0,89
6090,False,12,13,8,0,8
6091,False,7,8,6,0,6
6092,False,27,28,5,0,5
6093,False,51,52,81,0,81
6094,False,22,23,17,0,17
6095,False,42,43,11,0,11
6096,False,11,12,58,2,56
6097,False,6,7,9,0,9
6098,False,15,16,11,0,11
6099,False,29,30,48,1,47
6100,False,69,70,64,0,64
6101,False,51,52,27,0,27
6102,False,24,25,12,0,12
6103,False,44,45,31,7,24
6104,False,35,36,41,1,40
6105,False,10,11,4,4,0
6106,False,115,116,107,1,106
6107,False,114,115,156,2,154
6108,False,40,41,20,0,20
6109,False,4,5,1,0,1
6110,False,10,11,6,0,6
6111,False,40,41,23,0,23
6112,False,22,23,53,0,53
6113,False,19,20,7,2,5
6114,False,8,9,28,0,28
6115,False,16,17,11,0,11
6116,False,148,149,104,2,102
6117,False,3,4,5,0,5
6118,False,49,50,47,1,46
6119,False,7,8,4,0,4
6120,False,9,10,9,0,9
6121,False,17,18,12,0,12
6122,False,44,45,66,1,65
6123,False,51,52,33,0,33
6124,False,23,24,18,0,18
6125,False,113,114,92,7,85
6126,False,21,22,10,0,10
6127,False,13,14,15,0,15
6128,False,19,20,9,0,9
6129,False,4,5,3,0,3
6130,False,47,48,37,0,37
6131,False,20,21,8,1,7
6132,False,16,17,22,0,22
6133,False,4,5,0,0,0
6134,False,21,22,24,1,23
6135,False,37,38,19,0,19
6136,False,9,10,15,0,15
6137,False,6,7,8,0,8
6138,False,10,11,8,0,8
6139,False,28,29,43,1,42
6140,False,30,31,18,0,18
6141,False,35,36,40,1,39
6142,False,32,33,31,2,29
6143,False,20,21,48,0,48
6144,False,9,10,2,0,2
6145,False,108,109,88,1,87
6146,False,54,55,64,0,64
6147,False,8,9,30,1,29
6148,False,25,26,38,0,38
6149,False,30,31,17,0,17
6150,False,45,46,40,1,39
6151,False,39,40,36,0,36
6152,False,49,50,51,1,50
6153,False,41,42,66,2,64
6154,False,11,12,6,0,6
6155,False,30,31,75,3,72
6156,False,20,21,18,0,18
6157,False,22,23,23,0,23
6158,False,30,31,33,2,31
6159,False,50,51,44,1,43
6160,False,11,12,9,0,9
6161,False,23,24,10,0,10
6162,False,34,35,11,0,11
6163,False,46,47,32,0,32
6164,False,49,50,27,1,26
6165,False,9,10,5,1,4
6166,False,16,17,58,1,57
6167,False,46,47,50,0,50
6168,False,36,37,23,0,23
6169,False,51,52,19,0,19
6170,False,67,68,40,1,39
6171,False,40,41,74,1,73
6172,False,87,88,99,0,99
6173,False,59,60,11,0,11
6174,False,41,42,27,1,26
6175,False,36,37,51,1,50
6176,False,43,44,33,0,33
6177,False,31,32,42,4,38
6178,False,13,14,9,0,9
6179,False,30,31,19,0,19
6180,False,38,39,20,0,20
6181,False,50,51,44,0,44
6182,False,25,26,29,0,29
6183,False,23,24,14,0,14
6184,False,13,14,14,2,12
6185,False,39,40,26,0,26
6186,False,43,44,22,0,22
6187,False,40,41,28,0,28
6188,False,79,80,27,0,27
6189,False,31,32,22,1,21
6190,False,39,40,9,2,7
6191,False,76,77,55,3,52
6192,False,12,13,2,0,2
6193,False,33,34,16,0,16
6194,False,41,42,27,0,27
6195,False,16,17,5,0,5
6196,False,46,47,33,1,32
6197,False,52,53,48,0,48
6198,False,94,95,66,0,66
6199,False,54,55,36,0,36
6200,False,82,83,48,0,48
6201,False,23,24,28,0,28
6202,False,12,13,31,0,31
6203,False,9,10,3,0,3
6204,False,50,51,45,0,45
6205,False,43,44,67,1,66
6206,False,88,89,52,0,52
6207,False,12,13,2,0,2
6208,False,5,6,2,0,2
6209,False,24,25,17,0,17
6210,False,21,22,29,0,29
6211,False,108,109,56,1,55
6212,False,37,38,58,2,56
6213,False,44,45,27,0,27
6214,False,13,14,40,1,39
6215,False,14,15,24,0,24
6216,False,39,40,32,0,32
6217,False,36,37,67,0,67
6218,False,21,22,35,2,33
6219,False,11,12,9,0,9
6220,False,9,10,3,0,3
6221,False,16,17,21,0,21
6222,False,4,5,2,0,2
6223,False,32,33,76,0,76
6224,False,27,28,37,1,36
6225,False,31,32,36,0,36
6226,False,19,20,2,0,2
6227,False,19,20,16,1,15
6228,False,31,32,18,1,17
6229,False,27,28,44,0,44
6230,False,4,5,2,0,2
6231,False,40,41,58,0,58
6232,False,5,6,3,0,3
6233,False,7,8,3,0,3
6234,False,26,27,13,0,13
6235,False,11,12,8,0,8
6236,False,12,13,4,0,4
6237,False,29,30,11,0,11
6238,False,27,28,42,0,42
6239,False,55,56,55,0,55
6240,False,45,46,38,0,38
6241,False,5,6,0,0,0
6242,False,31,32,42,0,42
6243,False,19,20,36,0,36
6244,False,59,60,55,0,55
6245,False,69,70,41,2,39
6246,False,20,21,39,17,22
6247,False,29,30,18,4,14
6248,False,11,12,28,10,18
6249,False,29,30,46,1,45
6250,False,14,15,4,1,3
6251,False,39,40,23,0,23
6252,False,78,79,68,0,68
6253,False,39,40,15,0,15
6254,False,12,13,12,0,12
6255,False,40,41,38,0,38
6256,False,38,39,21,0,21
6257,False,48,49,46,3,43
6258,False,42,43,92,0,92
6259,False,53,54,26,0,26
6260,False,56,57,60,0,60
6261,False,17,18,5,0,5
6262,False,41,42,71,1,70
6263,False,28,29,89,0,89
6264,False,28,29,31,1,30
6265,False,26,27,52,1,51
6266,False,11,12,1,1,0
6267,False,78,79,41,0,41
6268,False,29,30,21,2,19
6269,False,40,41,56,1,55
6270,False,40,41,71,0,71
6271,False,6,7,23,0,23
6272,False,29,30,20,0,20
6273,False,22,23,42,5,37
6274,False,27,28,17,0,17
6275,False,4,5,2,0,2
6276,False,15,16,24,0,24
6277,False,72,73,63,0,63
6278,False,53,54,41,0,41
6279,False,42,43,31,0,31
6280,False,47,48,38,1,37
6281,False,36,37,33,0,33
6282,False,62,63,40,0,40
6283,False,59,60,49,3,46
6284,False,25,26,16,0,16
6285,False,74,75,123,9,114
6286,False,56,57,40,6,34
6287,False,18,19,8,0,8
6288,False,21,22,4,0,4
6289,False,67,68,44,0,44
6290,False,15,16,3,1,2
6291,False,9,10,15,0,15
6292,False,33,34,70,0,70
6293,False,8,9,5,0,5
6294,False,8,9,3,0,3
6295,False,28,29,11,0,11
6296,False,44,45,26,0,26
6297,False,5,6,30,0,30
6298,False,22,23,23,0,23
6299,False,24,25,8,0,8
6300,False,44,45,39,0,39
6301,False,48,49,33,0,33
6302,False,12,13,19,0,19
6303,False,69,70,28,3,25
6304,False,3,4,3,0,3
6305,False,13,14,14,1,13
6306,False,24,25,9,0,9
6307,False,17,18,32,0,32
6308,False,16,17,21,0,21
6309,False,18,19,1,0,1
6310,False,49,50,42,0,42
6311,False,29,30,83,1,82
6312,False,71,72,40,0,40
6313,False,16,17,13,1,12
6314,False,13,14,65,1,64
6315,False,22,23,38,1,37
6316,False,13,14,9,0,9
6317,False,35,36,19,1,18
6318,False,21,22,23,0,23
6319,False,38,39,18,0,18
6320,False,22,23,31,1,30
6321,False,15,16,65,0,65
6322,False,43,44,40,5,35
6323,False,25,26,8,0,8
6324,False,56,57,31,0,31
6325,False,21,22,20,1,19
6326,False,32,33,33,1,32
6327,False,25,26,59,1,58
6328,False,27,28,15,0,15
6329,False,26,27,16,0,16
6330,False,42,43,17,0,17
6331,False,4,5,2,0,2
6332,False,28,29,33,1,32
6333,False,22,23,7,0,7
6334,False,45,46,35,0,35
6335,False,116,117,63,3,60
6336,False,35,36,29,0,29
6337,False,20,21,2,0,2
6338,False,28,29,35,2,33
6339,False,49,50,38,0,38
6340,False,4,5,6,1,5
6341,False,38,39,24,0,24
6342,False,28,29,14,0,14
6343,False,52,53,46,0,46
6344,False,52,53,19,0,19
6345,False,66,67,48,1,47
6346,False,31,32,13,0,13
6347,False,40,41,61,2,59
6348,False,18,19,17,0,17
6349,False,58,59,21,1,20
6350,False,48,49,75,0,75
6351,False,46,47,30,0,30
6352,False,25,26,27,0,27
6353,False,16,17,7,0,7
6354,False,34,35,29,0,29
6355,False,91,92,57,4,53
6356,False,64,65,101,5,96
6357,False,68,69,34,4,30
6358,False,23,24,11,0,11
6359,False,29,30,36,0,36
6360,False,51,52,42,0,42
6361,False,13,14,4,0,4
6362,False,43,44,20,0,20
6363,False,4,5,0,0,0
6364,False,11,12,9,0,9
6365,False,37,38,73,1,72
6366,False,23,24,30,0,30
6367,False,25,26,20,0,20
6368,False,59,60,20,2,18
6369,False,5,6,4,0,4
6370,False,35,36,19,0,19
6371,False,8,9,2,0,2
6372,False,12,13,37,0,37
6373,False,31,32,22,0,22
6374,False,35,36,30,1,29
6375,False,41,42,17,0,17
6376,False,66,67,66,0,66
6377,False,21,22,34,0,34
6378,False,11,12,7,0,7
6379,False,16,17,16,0,16
6380,False,32,33,72,2,70
6381,False,37,38,73,0,73
6382,False,34,35,67,0,67
6383,False,40,41,30,0,30
6384,False,45,46,47,0,47
6385,False,10,11,7,0,7
6386,False,17,18,14,0,14
6387,False,28,29,19,0,19
6388,False,54,55,41,1,40
6389,False,45,46,74,2,72
6390,False,12,13,2,0,2
6391,False,21,22,12,0,12
6392,False,34,35,58,0,58
6393,False,20,21,7,1,6
6394,False,52,53,33,0,33
6395,False,39,40,64,2,62
6396,False,126,127,78,0,78
6397,False,11,12,58,0,58
6398,False,16,17,7,0,7
6399,False,29,30,43,0,43
6400,False,115,116,89,0,89
6401,False,63,64,60,1,59
6402,False,35,36,57,1,56
6403,False,26,27,19,0,19
6404,False,64,65,65,0,65
6405,False,28,29,44,0,44
6406,False,65,66,73,0,73
6407,False,3,4,3,1,2
6408,False,34,35,20,0,20
6409,False,38,39,32,0,32
6410,False,19,20,10,0,10
6411,False,16,17,38,5,33
6412,False,23,24,32,0,32
6413,False,42,43,42,0,42
6414,False,30,31,28,0,28
6415,False,41,42,43,0,43
6416,False,31,32,14,0,14
6417,False,15,16,75,0,75
6418,False,39,40,5,0,5
6419,False,6,7,2,0,2
6420,False,35,36,23,0,23
6421,False,30,31,13,0,13
6422,False,30,31,60,0,60
6423,False,30,31,57,2,55
6424,False,37,38,41,0,41
6425,False,41,42,35,0,35
6426,False,26,27,14,0,14
6427,False,11,12,2,2,0
6428,False,37,38,18,0,18
6429,False,25,26,17,0,17
6430,False,64,65,37,0,37
6431,False,31,32,49,0,49
6432,False,6,7,4,0,4
6433,False,11,12,6,0,6
6434,False,34,35,14,0,14
6435,False,17,18,30,0,30
6436,False,17,18,10,0,10
6437,False,42,43,34,0,34
6438,False,56,57,46,0,46
6439,False,21,22,12,0,12
6440,False,42,43,45,0,45
6441,False,27,28,40,0,40
6442,False,26,27,30,0,30
6443,False,48,49,51,0,51
6444,False,33,34,33,1,32
6445,False,12,13,31,2,29
6446,False,34,35,19,1,18
6447,False,7,8,13,0,13
6448,False,28,29,18,0,18
6449,False,13,14,2,1,1
6450,False,94,95,58,3,55
6451,False,114,115,62,0,62
6452,False,49,50,34,0,34
6453,False,31,32,21,0,21
6454,False,33,34,21,0,21
6455,False,56,57,18,0,18
6456,False,27,28,14,0,14
6457,False,14,15,25,0,25
6458,False,21,22,16,0,16
6459,False,13,14,26,0,26
6460,False,10,11,5,2,3
6461,False,39,40,23,0,23
6462,False,27,28,19,0,19
6463,False,15,16,81,2,79
6464,False,30,31,72,3,69
6465,False,51,52,16,2,14
6466,False,24,25,42,0,42
6467,False,20,21,10,0,10
6468,False,57,58,39,0,39
6469,False,57,58,34,3,31
6470,False,19,20,46,0,46
6471,False,28,29,9,0,9
6472,False,6,7,14,0,14
6473,False,54,55,77,0,77
6474,False,34,35,23,1,22
6475,False,50,51,35,1,34
6476,False,12,13,25,4,21
6477,False,31,32,27,0,27
6478,False,88,89,82,0,82
6479,False,7,8,38,0,38
6480,False,8,9,14,0,14
6481,False,12,13,12,0,12
6482,False,66,67,52,0,52
6483,False,37,38,35,0,35
6484,False,24,25,20,0,20
6485,False,35,36,16,0,16
6486,False,8,9,16,0,16
6487,False,30,31,51,3,48
6488,False,32,33,19,0,19
6489,False,20,21,6,0,6
6490,False,18,19,6,0,6
6491,False,58,59,48,0,48
6492,False,17,18,47,1,46
6493,False,85,86,57,0,57
6494,False,54,55,27,2,25
6495,False,37,38,90,2,88
6496,False,30,31,30,0,30
6497,False,18,19,16,2,14
6498,False,12,13,3,0,3
6499,False,21,22,12,0,12
6500,False,32,33,44,0,44
6501,False,6,7,28,0,28
6502,False,12,13,6,0,6
6503,False,8,9,19,1,18
6504,False,54,55,39,0,39
6505,False,63,64,38,1,37
6506,False,15,16,41,0,41
6507,False,11,12,10,4,6
6508,False,10,11,4,0,4
6509,False,20,21,13,0,13
6510,False,43,44,55,1,54
6511,False,4,5,3,0,3
6512,False,11,12,6,1,5
6513,False,36,37,49,1,48
6514,False,45,46,77,1,76
6515,False,5,6,7,0,7
6516,False,16,17,8,0,8
6517,False,17,18,7,0,7
6518,False,28,29,21,0,21
6519,False,23,24,28,0,28
6520,False,42,43,45,1,44
6521,False,6,7,7,0,7
6522,False,2,3,7,0,7
6523,False,31,32,8,0,8
6524,False,14,15,6,1,5
6525,False,26,27,13,0,13
6526,False,67,68,78,9,69
6527,False,10,11,10,0,10
6528,False,39,40,34,1,33
6529,False,18,19,55,0,55
6530,False,23,24,28,0,28
6531,False,12,13,51,0,51
6532,False,29,30,15,0,15
6533,False,11,12,33,0,33
6534,False,19,20,9,1,8
6535,False,17,18,12,2,10
6536,False,43,44,21,0,21
6537,False,28,29,18,2,16
6538,False,20,21,30,0,30
6539,False,26,27,13,0,13
6540,False,28,29,9,0,9
6541,False,33,34,22,1,21
6542,False,7,8,3,0,3
6543,False,24,25,15,0,15
6544,False,8,9,3,0,3
6545,False,28,29,15,0,15
6546,False,20,21,37,1,36
6547,False,8,9,0,0,0
6548,False,25,26,39,0,39
6549,False,36,37,45,3,42
6550,False,14,15,7,1,6
6551,False,11,12,8,0,8
6552,False,11,12,5,2,3
6553,False,23,24,18,1,17
6554,False,26,27,10,0,10
6555,False,6,7,2,0,2
6556,False,16,17,13,1,12
6557,False,122,123,96,2,94
6558,False,16,17,35,3,32
6559,False,24,25,38,0,38
6560,False,27,28,11,0,11
6561,False,15,16,28,2,26
6562,False,20,21,13,0,13
6563,False,28,29,31,1,30
6564,False,46,47,52,1,51
6565,False,34,35,6,3,3
6566,False,29,30,64,2,62
6567,False,5,6,2,0,2
6568,False,18,19,17,1,16
6569,False,15,16,11,0,11
6570,False,73,74,57,1,56
6571,False,25,26,17,0,17
6572,False,28,29,73,0,73
6573,False,73,74,50,11,39
6574,False,24,25,37,0,37
6575,False,18,19,6,0,6
6576,False,34,35,9,0,9
6577,False,37,38,59,0,59
6578,False,45,46,98,0,98
6579,False,45,46,37,0,37
6580,False,8,9,15,0,15
6581,False,57,58,43,0,43
6582,False,140,141,84,0,84
6583,False,36,37,32,0,32
6584,False,23,24,21,0,21
6585,False,30,31,32,3,29
6586,False,21,22,32,2,30
6587,False,14,15,5,0,5
6588,False,58,59,25,1,24
6589,False,68,69,75,2,73
6590,False,62,63,33,3,30
6591,False,92,93,40,0,40
6592,False,74,75,61,0,61
6593,False,14,15,3,1,2
6594,False,14,15,18,0,18
6595,False,22,23,31,0,31
6596,False,21,22,8,1,7
6597,False,4,5,0,0,0
6598,False,19,20,32,0,32
6599,False,64,65,57,1,56
6600,False,57,58,41,0,41
6601,False,19,20,14,0,14
6602,False,17,18,38,0,38
6603,False,35,36,60,0,60
6604,False,87,88,90,3,87
6605,False,49,50,53,0,53
6606,False,122,123,104,1,103
6607,False,37,38,78,6,72
6608,False,90,91,60,0,60
6609,False,110,111,105,0,105
6610,False,54,55,41,0,41
6611,False,55,56,85,1,84
6612,False,27,28,9,1,8
6613,False,39,40,43,3,40
6614,False,16,17,6,1,5
6615,False,37,38,6,0,6
6616,False,62,63,84,0,84
6617,False,157,158,118,2,116
6618,False,15,16,53,0,53
6619,False,35,36,34,0,34
6620,False,6,7,0,0,0
6621,False,65,66,27,1,26
6622,False,46,47,24,0,24
6623,False,21,22,9,0,9
6624,False,9,10,29,0,29
6625,False,10,11,12,0,12
6626,False,19,20,83,2,81
6627,False,22,23,34,2,32
6628,False,6,7,1,0,1
6629,False,15,16,14,0,14
6630,False,28,29,87,2,85
6631,False,190,191,118,0,118
6632,False,39,40,45,1,44
6633,False,29,30,38,1,37
6634,False,54,55,36,0,36
6635,False,35,36,44,0,44
6636,False,28,29,64,0,64
6637,False,36,37,17,0,17
6638,False,64,65,77,0,77
6639,False,54,55,68,0,68
6640,False,73,74,48,4,44
6641,False,36,37,73,0,73
6642,False,66,67,58,1,57
6643,False,29,30,27,0,27
6644,False,37,38,16,0,16
6645,False,24,25,32,0,32
6646,False,19,20,17,0,17
6647,False,59,60,41,0,41
6648,False,7,8,1,1,0
6649,False,7,8,0,0,0
6650,False,7,8,22,0,22
6651,False,5,6,2,2,0
6652,False,22,23,11,0,11
6653,False,43,44,20,0,20
6654,False,94,95,72,0,72
6655,False,86,87,43,1,42
6656,False,39,40,84,0,84
6657,False,65,66,70,1,69
6658,False,13,14,28,0,28
6659,False,30,31,79,2,77
6660,False,51,52,13,1,12
6661,False,51,52,51,0,51
6662,False,35,36,22,0,22
6663,False,24,25,26,0,26
6664,False,44,45,21,0,21
6665,False,15,16,11,0,11
6666,False,44,45,49,1,48
6667,False,16,17,13,0,13
6668,False,10,11,10,0,10
6669,False,98,99,29,0,29
6670,False,11,12,11,0,11
6671,False,34,35,3,0,3
6672,False,7,8,33,0,33
6673,False,14,15,27,0,27
6674,False,31,32,23,0,23
6675,False,52,53,33,0,33
6676,False,12,13,18,5,13
6677,False,17,18,5,0,5
6678,False,95,96,67,1,66
6679,False,36,37,23,0,23
6680,False,26,27,15,0,15
6681,False,74,75,98,0,98
6682,False,71,72,107,0,107
6683,False,17,18,8,0,8
6684,False,12,13,8,0,8
6685,False,61,62,54,0,54
6686,False,16,17,9,2,7
6687,False,5,6,6,1,5
6688,False,8,9,5,0,5
6689,False,30,31,50,0,50
6690,False,15,16,18,0,18
6691,False,18,19,9,0,9
6692,False,60,61,28,1,27
6693,False,24,25,17,0,17
6694,False,10,11,5,0,5
6695,False,41,42,26,0,26
6696,False,41,42,56,0,56
6697,False,29,30,61,0,61
6698,False,53,54,39,3,36
6699,False,74,75,79,0,79
6700,False,19,20,26,0,26
6701,False,49,50,32,0,32
6702,False,69,70,59,1,58
6703,False,34,35,19,2,17
6704,False,16,17,5,0,5
6705,False,13,14,5,2,3
6706,False,33,34,13,0,13
6707,False,34,35,16,0,16
6708,False,25,26,14,1,13
6709,False,27,28,31,0,31
6710,False,19,20,6,0,6
6711,False,7,8,6,0,6
6712,False,29,30,33,1,32
6713,False,10,11,2,0,2
6714,False,2,3,0,0,0
6715,False,24,25,23,0,23
6716,False,43,44,44,0,44
6717,False,16,17,3,0,3
6718,False,32,33,16,1,15
6719,False,25,26,15,0,15
6720,False,96,97,62,6,56
6721,False,15,16,9,1,8
6722,False,35,36,33,0,33
6723,False,13,14,4,0,4
6724,False,32,33,29,0,29
6725,False,3,4,2,0,2
6726,False,3,4,1,0,1
6727,False,38,39,47,2,45
6728,False,6,7,3,0,3
6729,False,13,14,14,1,13
6730,False,18,19,10,0,10
6731,False,60,61,21,0,21
6732,False,8,9,35,0,35
6733,False,7,8,5,0,5
6734,False,43,44,42,1,41
6735,False,27,28,14,0,14
6736,False,46,47,55,2,53
6737,False,32,33,78,0,78
6738,False,105,106,84,1,83
6739,False,26,27,16,0,16
6740,False,24,25,15,0,15
6741,False,33,34,10,1,9
6742,False,8,9,34,0,34
6743,False,19,20,10,0,10
6744,False,36,37,22,0,22
6745,False,23,24,50,0,50
6746,False,13,14,30,1,29
6747,False,48,49,105,0,105
6748,False,24,25,9,0,9
6749,False,47,48,37,0,37
6750,False,15,16,68,1,67
6751,False,21,22,53,1,52
6752,False,15,16,24,0,24
6753,False,18,19,13,1,12
6754,False,23,24,16,0,16
6755,False,176,177,56,0,56
6756,False,32,33,13,0,13
6757,False,35,36,62,0,62
6758,False,18,19,41,0,41
6759,False,30,31,18,0,18
6760,False,33,34,17,0,17
6761,False,18,19,16,0,16
6762,False,53,54,84,1,83
6763,False,9,10,4,0,4
6764,False,16,17,12,0,12
6765,False,41,42,73,2,71
6766,False,29,30,59,1,58
6767,False,111,112,71,5,66
6768,False,35,36,24,0,24
6769,False,42,43,47,0,47
6770,False,36,37,50,0,50
6771,False,19,20,15,1,14
6772,False,4,5,1,0,1
6773,False,52,53,25,0,25
6774,False,12,13,13,0,13
6775,False,40,41,32,0,32
6776,False,5,6,12,0,12
6777,False,25,26,20,1,19
6778,False,29,30,11,0,11
6779,False,52,53,2,0,2
6780,False,81,82,77,0,77
6781,False,13,14,3,0,3
6782,False,45,46,20,0,20
6783,False,4,5,1,0,1
6784,False,35,36,56,0,56
6785,False,29,30,25,0,25
6786,False,20,21,16,0,16
6787,False,11,12,33,0,33
6788,False,30,31,17,1,16
6789,False,6,7,5,0,5
6790,False,49,50,37,0,37
6791,False,38,39,24,0,24
6792,False,25,26,18,0,18
6793,False,31,32,56,1,55
6794,False,32,33,44,0,44
6795,False,36,37,38,0,38
6796,False,8,9,7,0,7
6797,False,25,26,20,0,20
6798,False,16,17,30,0,30
6799,False,63,64,34,1,33
6800,False,56,57,58,10,48
6801,False,149,150,40,6,34
6802,False,36,37,43,0,43
6803,False,43,44,25,0,25
6804,False,11,12,5,0,5
6805,False,89,90,50,0,50
6806,False,54,55,50,0,50
6807,False,34,35,20,0,20
6808,False,38,39,19,0,19
6809,False,50,51,21,0,21
6810,False,74,75,25,0,25
6811,False,74,75,54,0,54
6812,False,39,40,52,0,52
6813,False,24,25,40,1,39
6814,False,31,32,35,2,33
6815,False,65,66,64,0,64
6816,False,37,38,39,1,38
6817,False,42,43,22,3,19
6818,False,23,24,33,0,33
6819,False,24,25,112,1,111
6820,False,11,12,7,0,7
6821,False,42,43,26,0,26
6822,False,37,38,34,0,34
6823,False,11,12,36,12,24
6824,False,19,20,28,1,27
6825,False,29,30,24,0,24
6826,False,8,9,2,0,2
6827,False,32,33,14,0,14
6828,False,32,33,35,0,35
6829,False,35,36,32,1,31
6830,False,50,51,18,0,18
6831,False,23,24,56,0,56
6832,False,10,11,4,0,4
6833,False,19,20,14,0,14
6834,False,40,41,42,0,42
6835,False,8,9,2,2,0
6836,False,35,36,32,0,32
6837,False,71,72,57,0,57
6838,False,51,52,65,0,65
6839,False,31,32,17,0,17
6840,False,16,17,23,0,23
6841,False,44,45,36,1,35
6842,False,9,10,2,0,2
6843,False,43,44,14,0,14
6844,False,27,28,5,0,5
6845,False,41,42,53,0,53
6846,False,9,10,6,0,6
6847,False,26,27,14,0,14
6848,False,49,50,19,1,18
6849,False,23,24,62,0,62
6850,False,35,36,24,0,24
6851,False,30,31,23,1,22
6852,False,19,20,22,0,22
6853,False,183,184,143,1,142
6854,False,28,29,19,0,19
6855,False,24,25,46,2,44
6856,False,83,84,83,1,82
6857,False,18,19,0,0,0
6858,False,21,22,12,0,12
6859,False,21,22,12,0,12
6860,False,45,46,82,1,81
6861,False,18,19,20,0,20
6862,False,37,38,41,0,41
6863,False,70,71,63,0,63
6864,False,24,25,19,0,19
6865,False,28,29,24,1,23
6866,False,42,43,21,0,21
6867,False,33,34,73,0,73
6868,False,17,18,9,0,9
6869,False,37,38,89,0,89
6870,False,15,16,7,2,5
6871,False,39,40,51,4,47
6872,False,47,48,40,0,40
6873,False,13,14,23,0,23
6874,False,14,15,19,0,19
6875,False,9,10,10,0,10
6876,False,32,33,42,0,42
6877,False,18,19,32,0,32
6878,False,44,45,20,0,20
6879,False,40,41,45,0,45
6880,False,15,16,27,0,27
6881,False,7,8,25,3,22
6882,False,40,41,20,0,20
6883,False,37,38,17,0,17
6884,False,62,63,88,0,88
6885,False,5,6,0,0,0
6886,False,54,55,81,1,80
6887,False,9,10,10,1,9
6888,False,13,14,36,6,30
6889,False,48,49,25,0,25
6890,False,17,18,17,0,17
6891,False,8,9,3,0,3
6892,False,42,43,17,0,17
6893,False,31,32,36,2,34
6894,False,27,28,28,0,28
6895,False,14,15,14,0,14
6896,False,6,7,3,0,3
6897,False,21,22,6,0,6
6898,False,24,25,27,2,25
6899,False,26,27,18,1,17
6900,False,26,27,39,0,39
6901,False,39,40,27,0,27
6902,False,14,15,13,0,13
6903,False,8,9,2,0,2
6904,False,5,6,5,2,3
6905,False,52,53,42,0,42
6906,False,27,28,8,0,8
6907,False,29,30,28,1,27
6908,False,52,53,63,2,61
6909,False,34,35,59,0,59
6910,False,42,43,32,0,32
6911,False,46,47,100,1,99
6912,False,11,12,3,0,3
6913,False,4,5,1,0,1
6914,False,50,51,30,0,30
6915,False,28,29,28,0,28
6916,False,26,27,16,0,16
6917,False,13,14,7,0,7
6918,False,3,4,0,0,0
6919,False,9,10,4,0,4
6920,False,17,18,18,1,17
6921,False,50,51,28,0,28
6922,False,4,5,1,0,1
6923,False,23,24,35,0,35
6924,False,24,25,45,0,45
6925,False,19,20,18,0,18
6926,False,38,39,13,0,13
6927,False,23,24,73,0,73
6928,False,21,22,57,1,56
6929,False,52,53,43,0,43
6930,False,30,31,56,1,55
6931,False,13,14,16,0,16
6932,False,38,39,28,0,28
6933,False,36,37,18,1,17
6934,False,19,20,30,0,30
6935,False,23,24,12,1,11
6936,False,60,61,38,1,37
6937,False,38,39,31,1,30
6938,False,21,22,17,0,17
6939,False,17,18,13,0,13
6940,False,18,19,12,0,12
6941,False,19,20,0,0,0
6942,False,25,26,17,0,17
6943,False,51,52,16,0,16
6944,False,30,31,10,0,10
6945,False,44,45,34,0,34
6946,False,42,43,27,0,27
6947,False,40,41,42,2,40
6948,False,28,29,17,0,17
6949,False,29,30,7,0,7
6950,False,7,8,32,0,32
6951,False,23,24,4,0,4
6952,False,10,11,10,0,10
6953,False,26,27,21,0,21
6954,False,31,32,25,0,25
6955,False,33,34,42,0,42
6956,False,28,29,14,0,14
6957,False,13,14,3,0,3
6958,False,31,32,49,0,49
6959,False,50,51,28,0,28
6960,False,53,54,24,2,22
6961,False,29,30,15,1,14
6962,False,28,29,58,0,58
6963,False,33,34,38,2,36
6964,False,71,72,25,2,23
6965,False,45,46,22,0,22
6966,False,18,19,13,0,13
6967,False,46,47,104,1,103
6968,False,53,54,28,0,28
6969,False,17,18,3,0,3
6970,False,33,34,39,0,39
6971,False,27,28,35,1,34
6972,False,36,37,28,0,28
6973,False,21,22,15,0,15
6974,False,31,32,53,1,52
6975,False,33,34,35,2,33
6976,False,16,17,15,0,15
6977,False,39,40,81,2,79
6978,False,27,28,5,0,5
6979,False,25,26,21,0,21
6980,False,60,61,57,10,47
6981,False,55,56,26,0,26
6982,False,28,29,52,0,52
6983,False,20,21,64,1,63
6984,False,32,33,42,0,42
6985,False,42,43,18,0,18
6986,False,15,16,50,0,50
6987,False,43,44,25,0,25
6988,False,29,30,14,0,14
6989,False,30,31,19,2,17
6990,False,86,87,46,3,43
6991,False,84,85,64,0,64
6992,False,3,4,6,0,6
6993,False,20,21,82,0,82
6994,False,43,44,17,1,16
6995,False,41,42,35,0,35
6996,False,34,35,17,1,16
6997,False,67,68,28,0,28
6998,False,31,32,15,0,15
6999,False,38,39,66,1,65
7000,False,46,47,46,0,46
7001,False,4,5,4,0,4
7002,False,17,18,6,0,6
7003,False,12,13,10,0,10
7004,False,5,6,81,8,73
7005,False,36,37,21,0,21
7006,False,15,16,37,1,36
7007,False,17,18,4,0,4
7008,False,22,23,10,0,10
7009,False,63,64,141,3,138
7010,False,14,15,12,0,12
7011,False,69,70,39,5,34
7012,False,16,17,5,0,5
7013,False,27,28,24,1,23
7014,False,41,42,41,1,40
7015,False,48,49,48,1,47
7016,False,17,18,4,1,3
7017,False,18,19,14,0,14
7018,False,38,39,68,0,68
7019,False,12,13,14,0,14
7020,False,66,67,42,0,42
7021,False,35,36,50,0,50
7022,False,19,20,12,0,12
7023,False,46,47,54,0,54
7024,False,18,19,35,0,35
7025,False,43,44,53,0,53
7026,False,50,51,31,0,31
7027,False,58,59,38,0,38
7028,False,20,21,17,0,17
7029,False,31,32,57,0,57
7030,False,19,20,63,0,63
7031,False,18,19,14,0,14
7032,False,122,123,79,0,79
7033,False,32,33,18,0,18
7034,False,55,56,17,2,15
7035,False,45,46,29,0,29
7036,False,29,30,23,0,23
7037,False,12,13,5,0,5
7038,False,18,19,11,0,11
7039,False,35,36,41,0,41
7040,False,16,17,10,0,10
7041,False,35,36,33,0,33
7042,False,38,39,22,0,22
7043,False,9,10,29,3,26
7044,False,40,41,59,1,58
7045,False,46,47,36,0,36
7046,False,90,91,106,1,105
7047,False,19,20,13,0,13
7048,False,18,19,38,1,37
7049,False,25,26,21,0,21
7050,False,26,27,14,1,13
7051,False,86,87,48,2,46
7052,False,8,9,5,0,5
7053,False,89,90,50,0,50
7054,False,28,29,44,0,44
7055,False,34,35,66,2,64
7056,False,36,37,71,0,71
7057,False,7,8,2,0,2
7058,False,87,88,69,0,69
7059,False,75,76,63,0,63
7060,False,42,43,40,0,40
7061,False,35,36,33,0,33
7062,False,7,8,0,0,0
7063,False,20,21,11,0,11
7064,False,12,13,16,0,16
7065,False,8,9,4,0,4
7066,False,13,14,2,1,1
7067,False,29,30,6,0,6
7068,False,86,87,123,0,123
7069,False,6,7,2,1,1
7070,False,31,32,61,0,61
7071,False,23,24,21,0,21
7072,False,16,17,5,2,3
7073,False,2,3,5,0,5
7074,False,43,44,41,1,40
7075,False,20,21,13,2,11
7076,False,41,42,27,1,26
7077,False,21,22,15,0,15
7078,False,19,20,43,1,42
7079,False,36,37,26,0,26
7080,False,10,11,2,0,2
7081,False,33,34,45,0,45
7082,False,35,36,17,0,17
7083,False,15,16,12,0,12
7084,False,19,20,0,0,0
7085,False,21,22,16,0,16
7086,False,18,19,0,0,0
7087,False,28,29,32,0,32
7088,False,24,25,30,0,30
7089,False,30,31,36,0,36
7090,False,7,8,6,0,6
7091,False,19,20,20,1,19
7092,False,54,55,23,0,23
7093,False,4,5,3,0,3
7094,False,19,20,21,0,21
7095,False,26,27,27,0,27
7096,False,14,15,15,0,15
7097,False,45,46,25,0,25
7098,False,7,8,4,0,4
7099,False,24,25,4,0,4
7100,False,24,25,37,0,37
7101,False,38,39,59,0,59
7102,False,20,21,54,0,54
7103,False,47,48,57,1,56
7104,False,30,31,16,0,16
7105,False,6,7,1,0,1
7106,False,25,26,7,0,7
7107,False,17,18,13,0,13
7108,False,29,30,13,0,13
7109,False,23,24,15,1,14
7110,False,9,10,1,0,1
7111,False,14,15,3,1,2
7112,False,13,14,2,0,2
7113,False,48,49,80,2,78
7114,False,23,24,18,0,18
7115,False,51,52,24,0,24
7116,False,16,17,30,3,27
7117,False,23,24,15,0,15
7118,False,15,16,7,2,5
7119,False,12,13,15,0,15
7120,False,29,30,15,1,14
7121,False,34,35,35,2,33
7122,False,16,17,8,0,8
7123,False,79,80,77,0,77
7124,False,28,29,45,0,45
7125,False,20,21,19,0,19
7126,False,10,11,25,0,25
7127,False,85,86,79,2,77
7128,False,10,11,56,1,55
7129,False,25,26,16,1,15
7130,False,13,14,40,1,39
7131,False,25,26,22,0,22
7132,False,26,27,76,0,76
7133,False,5,6,4,0,4
7134,False,94,95,130,5,125
7135,False,91,92,90,0,90
7136,False,30,31,48,0,48
7137,False,46,47,36,1,35
7138,False,50,51,53,4,49
7139,False,11,12,0,0,0
7140,False,24,25,67,2,65
7141,False,7,8,4,0,4
7142,False,9,10,10,0,10
7143,False,11,12,26,0,26
7144,False,61,62,38,0,38
7145,False,12,13,5,2,3
7146,False,26,27,17,0,17
7147,False,45,46,81,3,78
7148,False,54,55,17,0,17
7149,False,19,20,38,1,37
7150,False,39,40,23,0,23
7151,False,33,34,22,1,21
7152,False,95,96,52,0,52
7153,False,14,15,0,0,0
7154,False,61,62,58,2,56
7155,False,19,20,54,5,49
7156,False,38,39,50,0,50
7157,False,2,3,0,0,0
7158,False,14,15,9,0,9
7159,False,34,35,33,1,32
7160,False,15,16,9,0,9
7161,False,21,22,19,0,19
7162,False,103,104,71,0,71
7163,False,78,79,50,0,50
7164,False,12,13,4,0,4
7165,False,8,9,4,1,3
7166,False,36,37,45,0,45
7167,False,13,14,5,1,4
7168,False,16,17,9,0,9
7169,False,15,16,33,0,33
7170,False,26,27,17,0,17
7171,False,37,38,5,0,5
7172,False,37,38,3,0,3
7173,False,15,16,20,0,20
7174,False,34,35,18,0,18
7175,False,13,14,32,3,29
7176,False,10,11,30,1,29
7177,False,41,42,30,0,30
7178,False,9,10,4,0,4
7179,False,14,15,15,1,14
7180,False,29,30,47,0,47
7181,False,37,38,46,0,46
7182,False,14,15,44,3,41
7183,False,5,6,2,0,2
7184,False,43,44,30,0,30
7185,False,35,36,75,2,73
7186,False,15,16,29,13,16
7187,False,23,24,18,0,18
7188,False,17,18,8,0,8
7189,False,6,7,4,0,4
7190,False,40,41,66,1,65
7191,False,22,23,34,0,34
7192,False,35,36,36,1,35
7193,False,12,13,3,0,3
7194,False,59,60,52,0,52
7195,False,48,49,28,0,28
7196,False,19,20,35,0,35
7197,False,9,10,1,0,1
7198,False,33,34,34,0,34
7199,False,53,54,24,0,24
7200,False,7,8,8,0,8
7201,False,29,30,15,0,15
7202,False,35,36,19,0,19
7203,False,22,23,17,2,15
7204,False,41,42,20,0,20
7205,False,5,6,16,0,16
7206,False,19,20,15,0,15
7207,False,14,15,4,0,4
7208,False,16,17,8,0,8
7209,False,49,50,29,0,29
7210,False,18,19,17,0,17
7211,False,61,62,74,0,74
7212,False,1,2,2,0,2
7213,False,43,44,24,0,24
7214,False,18,19,10,0,10
7215,False,130,131,64,0,64
7216,False,42,43,46,1,45
7217,False,18,19,10,0,10
7218,False,11,12,4,0,4
7219,False,10,11,4,0,4
7220,False,26,27,44,0,44
7221,False,9,10,1,0,1
7222,False,18,19,30,1,29
7223,False,39,40,27,1,26
7224,False,59,60,18,0,18
7225,False,32,33,23,3,20
7226,False,12,13,8,0,8
7227,False,76,77,17,0,17
7228,False,28,29,10,0,10
7229,False,26,27,40,0,40
7230,False,16,17,19,0,19
7231,False,40,41,32,0,32
7232,False,88,89,66,0,66
7233,False,29,30,9,0,9
7234,False,40,41,42,0,42
7235,False,19,20,13,0,13
7236,False,37,38,24,0,24
7237,False,35,36,17,1,16
7238,False,24,25,35,1,34
7239,False,20,21,43,0,43
7240,False,63,64,73,1,72
7241,False,13,14,3,0,3
7242,False,20,21,15,0,15
7243,False,33,34,39,0,39
7244,False,46,47,39,1,38
7245,False,11,12,1,0,1
7246,False,34,35,20,1,19
7247,False,82,83,72,0,72
7248,False,90,91,50,1,49
7249,False,30,31,20,0,20
7250,False,32,33,32,0,32
7251,False,3,4,5,0,5
7252,False,68,69,40,0,40
7253,False,11,12,6,0,6
7254,False,33,34,62,0,62
7255,False,9,10,3,0,3
7256,False,19,20,6,0,6
7257,False,64,65,32,1,31
7258,False,53,54,30,1,29
7259,False,15,16,36,0,36
7260,False,60,61,60,0,60
7261,False,32,33,6,1,5
7262,False,28,29,43,0,43
7263,False,32,33,80,0,80
7264,False,13,14,13,0,13
7265,False,65,66,59,9,50
7266,False,30,31,11,0,11
7267,False,173,174,136,0,136
7268,False,30,31,42,0,42
7269,False,34,35,41,0,41
7270,False,9,10,18,0,18
7271,False,36,37,8,0,8
7272,False,19,20,28,0,28
7273,False,39,40,25,0,25
7274,False,45,46,53,0,53
7275,False,31,32,23,0,23
7276,False,121,122,123,4,119
7277,False,15,16,10,0,10
7278,False,65,66,40,0,40
7279,False,12,13,6,2,4
7280,False,15,16,20,0,20
7281,False,15,16,11,0,11
7282,False,18,19,27,0,27
7283,False,14,15,8,0,8
7284,False,15,16,6,0,6
7285,False,26,27,39,0,39
7286,False,12,13,7,1,6
7287,False,13,14,5,0,5
7288,False,17,18,13,0,13
7289,False,10,11,30,0,30
7290,False,6,7,2,0,2
7291,False,24,25,41,0,41
7292,False,37,38,54,0,54
7293,False,41,42,49,0,49
7294,False,16,17,58,0,58
7295,False,37,38,23,0,23
7296,False,13,14,22,2,20
7297,False,11,12,2,0,2
7298,False,19,20,40,1,39
7299,False,17,18,9,0,9
7300,False,35,36,38,0,38
7301,False,29,30,40,1,39
7302,False,45,46,16,0,16
7303,False,48,49,85,0,85
7304,False,16,17,37,1,36
7305,False,42,43,34,0,34
7306,False,34,35,55,0,55
7307,False,17,18,17,0,17
7308,False,9,10,12,0,12
7309,False,25,26,23,0,23
7310,False,6,7,4,0,4
7311,False,33,34,30,0,30
7312,False,55,56,32,1,31
7313,False,107,108,91,1,90
7314,False,8,9,31,0,31
7315,False,8,9,21,0,21
7316,False,26,27,9,0,9
7317,False,35,36,44,0,44
7318,False,55,56,85,2,83
7319,False,28,29,10,0,10
7320,False,29,30,16,0,16
7321,False,9,10,25,0,25
7322,False,15,16,13,0,13
7323,False,31,32,37,0,37
7324,False,22,23,14,2,12
7325,False,6,7,1,0,1
7326,False,25,26,66,1,65
7327,False,26,27,18,0,18
7328,False,64,65,42,0,42
7329,False,21,22,23,0,23
7330,False,16,17,8,1,7
7331,False,55,56,61,0,61
7332,False,19,20,11,0,11
7333,False,53,54,53,1,52
7334,False,34,35,30,0,30
7335,False,50,51,62,1,61
7336,False,61,62,81,1,80
7337,False,17,18,13,0,13
7338,False,18,19,27,0,27
7339,False,26,27,46,0,46
7340,False,33,34,24,0,24
7341,False,18,19,9,0,9
7342,False,24,25,9,0,9
7343,False,33,34,48,0,48
7344,False,22,23,17,0,17
7345,False,49,50,29,0,29
7346,False,32,33,37,0,37
7347,False,17,18,34,0,34
7348,False,38,39,49,0,49
7349,False,4,5,39,0,39
7350,False,59,60,85,0,85
7351,False,51,52,29,1,28
7352,False,35,36,33,1,32
7353,False,17,18,6,2,4
7354,False,25,26,34,1,33
7355,False,18,19,14,0,14
7356,False,28,29,26,0,26
7357,False,47,48,63,1,62
7358,False,65,66,90,1,89
7359,False,11,12,10,1,9
7360,False,45,46,57,0,57
7361,False,12,13,4,1,3
7362,False,7,8,15,0,15
7363,False,18,19,2,1,1
7364,False,15,16,16,3,13
7365,False,57,58,15,1,14
7366,False,21,22,18,0,18
7367,False,32,33,27,0,27
7368,False,70,71,48,10,38
7369,False,21,22,8,0,8
7370,False,21,22,32,2,30
7371,False,3,4,0,0,0
7372,False,13,14,7,0,7
7373,False,100,101,96,1,95
7374,False,18,19,0,0,0
7375,False,36,37,9,0,9
7376,False,37,38,48,0,48
7377,False,13,14,9,1,8
7378,False,33,34,32,0,32
7379,False,32,33,24,2,22
7380,False,28,29,13,0,13
7381,False,13,14,7,0,7
7382,False,51,52,32,1,31
7383,False,17,18,39,0,39
7384,False,10,11,22,13,9
7385,False,82,83,50,5,45
7386,False,43,44,65,0,65
7387,False,27,28,54,0,54
7388,False,32,33,20,0,20
7389,False,14,15,11,1,10
7390,False,31,32,14,0,14
7391,False,20,21,19,1,18
7392,False,56,57,57,0,57
7393,False,30,31,26,0,26
7394,False,54,55,116,2,114
7395,False,8,9,5,0,5
7396,False,14,15,10,1,9
7397,False,36,37,47,0,47
7398,False,33,34,73,2,71
7399,False,21,22,14,0,14
7400,False,40,41,53,0,53
7401,False,16,17,11,0,11
7402,False,44,45,42,0,42
7403,False,23,24,15,0,15
7404,False,24,25,10,0,10
7405,False,31,32,25,0,25
7406,False,23,24,68,0,68
7407,False,16,17,8,0,8
7408,False,12,13,4,1,3
7409,False,51,52,15,0,15
7410,False,95,96,67,1,66
7411,False,14,15,9,0,9
7412,False,29,30,27,0,27
7413,False,44,45,25,0,25
7414,False,57,58,24,0,24
7415,False,70,71,51,0,51
7416,False,33,34,78,1,77
7417,False,121,122,71,0,71
7418,False,48,49,97,15,82
7419,False,14,15,3,0,3
7420,False,5,6,2,0,2
7421,False,12,13,3,1,2
7422,False,38,39,38,0,38
7423,False,56,57,28,1,27
7424,False,44,45,46,1,45
7425,False,21,22,4,0,4
7426,False,14,15,1,0,1
7427,False,16,17,8,0,8
7428,False,37,38,28,0,28
7429,False,32,33,40,0,40
7430,False,18,19,10,0,10
7431,False,35,36,53,0,53
7432,False,3,4,0,0,0
7433,False,67,68,62,0,62
7434,False,13,14,13,0,13
7435,False,17,18,37,0,37
7436,False,49,50,18,1,17
7437,False,27,28,34,3,31
7438,False,28,29,15,0,15
7439,False,22,23,17,0,17
7440,False,15,16,31,0,31
7441,False,46,47,3,0,3
7442,False,15,16,0,0,0
7443,False,31,32,16,0,16
7444,False,29,30,22,0,22
7445,False,36,37,27,0,27
7446,False,10,11,6,0,6
7447,False,49,50,51,4,47
7448,False,41,42,37,0,37
7449,False,8,9,4,0,4
7450,False,45,46,63,0,63
7451,False,42,43,57,0,57
7452,False,34,35,26,1,25
7453,False,46,47,22,0,22
7454,False,11,12,4,0,4
7455,False,41,42,21,0,21
7456,False,7,8,4,0,4
7457,False,37,38,10,0,10
7458,False,7,8,10,0,10
7459,False,13,14,20,0,20
7460,False,52,53,41,1,40
7461,False,23,24,7,0,7
7462,False,26,27,28,1,27
7463,False,52,53,40,0,40
7464,False,11,12,3,0,3
7465,False,5,6,4,0,4
7466,False,24,25,75,3,72
7467,False,11,12,28,0,28
7468,False,107,108,103,2,101
7469,False,194,195,131,1,130
7470,False,59,60,31,0,31
7471,False,13,14,49,0,49
7472,False,38,39,49,0,49
7473,False,19,20,57,0,57
7474,False,37,38,21,3,18
7475,False,60,61,27,1,26
7476,False,14,15,12,0,12
7477,False,51,52,46,1,45
7478,False,28,29,16,0,16
7479,False,26,27,60,1,59
7480,False,25,26,11,1,10
7481,False,15,16,14,0,14
7482,False,29,30,40,0,40
7483,False,38,39,42,0,42
7484,False,40,41,48,0,48
7485,False,3,4,4,0,4
7486,False,14,15,33,0,33
7487,False,44,45,55,0,55
7488,False,15,16,10,1,9
7489,False,39,40,20,0,20
7490,False,37,38,52,0,52
7491,False,14,15,8,0,8
7492,False,17,18,93,5,88
7493,False,8,9,14,0,14
7494,False,39,40,14,1,13
7495,False,17,18,3,1,2
7496,False,11,12,7,0,7
7497,False,40,41,33,1,32
7498,False,49,50,57,1,56
7499,False,16,17,6,0,6
7500,False,12,13,34,0,34
7501,False,35,36,16,0,16
7502,False,23,24,53,0,53
7503,False,24,25,17,0,17
7504,False,25,26,10,0,10
7505,False,46,47,24,0,24
7506,False,43,44,48,0,48
7507,False,13,14,34,5,29
7508,False,14,15,37,3,34
7509,False,20,21,10,0,10
7510,False,22,23,14,0,14
7511,False,34,35,29,0,29
7512,False,16,17,17,0,17
7513,False,9,10,6,0,6
7514,False,26,27,35,0,35
7515,False,67,68,84,1,83
7516,False,59,60,33,0,33
7517,False,49,50,78,0,78
7518,False,28,29,51,3,48
7519,False,75,76,36,3,33
7520,False,21,22,2,0,2
7521,False,22,23,37,0,37
7522,False,23,24,7,0,7
7523,False,41,42,39,2,37
7524,False,7,8,12,0,12
7525,False,21,22,37,0,37
7526,False,29,30,38,1,37
7527,False,30,31,8,0,8
7528,False,36,37,20,0,20
7529,False,29,30,18,0,18
7530,False,32,33,15,0,15
7531,False,7,8,4,0,4
7532,False,31,32,28,0,28
7533,False,15,16,25,1,24
7534,False,6,7,12,0,12
7535,False,21,22,9,0,9
7536,False,22,23,14,0,14
7537,False,42,43,65,1,64
7538,False,27,28,43,0,43
7539,False,21,22,12,0,12
7540,False,19,20,5,0,5
7541,False,38,39,104,1,103
7542,False,12,13,8,2,6
7543,False,12,13,2,0,2
7544,False,39,40,44,0,44
7545,False,28,29,38,2,36
7546,False,60,61,45,5,40
7547,False,28,29,21,0,21
7548,False,8,9,3,0,3
7549,False,9,10,2,0,2
7550,False,37,38,49,0,49
7551,False,11,12,27,15,12
7552,False,103,104,105,1,104
7553,False,44,45,39,0,39
7554,False,63,64,46,0,46
7555,False,46,47,17,0,17
7556,False,36,37,47,0,47
7557,False,32,33,30,0,30
7558,False,15,16,35,0,35
7559,False,97,98,38,0,38
7560,False,14,15,27,0,27
7561,False,7,8,9,0,9
7562,False,10,11,4,0,4
7563,False,5,6,5,0,5
7564,False,61,62,53,0,53
7565,False,31,32,59,0,59
7566,False,37,38,20,0,20
7567,False,23,24,44,0,44
7568,False,50,51,30,0,30
7569,False,7,8,42,1,41
7570,False,21,22,11,0,11
7571,False,41,42,42,1,41
7572,False,61,62,65,0,65
7573,False,19,20,13,0,13
7574,False,3,4,0,0,0
7575,False,28,29,12,0,12
7576,False,45,46,35,0,35
7577,False,25,26,46,0,46
7578,False,23,24,17,0,17
7579,False,79,80,34,1,33
7580,False,32,33,40,0,40
7581,False,8,9,6,2,4
7582,False,23,24,18,0,18
7583,False,33,34,20,0,20
7584,False,34,35,61,2,59
7585,False,49,50,41,0,41
7586,False,44,45,15,0,15
7587,False,17,18,8,0,8
7588,False,8,9,24,0,24
7589,False,15,16,4,0,4
7590,False,62,63,17,0,17
7591,False,16,17,37,0,37
7592,False,30,31,12,1,11
7593,False,21,22,19,0,19
7594,False,7,8,9,2,7
7595,False,28,29,34,0,34
7596,False,7,8,4,0,4
7597,False,24,25,52,0,52
7598,False,17,18,36,0,36
7599,False,31,32,9,0,9
7600,False,7,8,8,0,8
7601,False,54,55,16,0,16
7602,False,42,43,37,1,36
7603,False,50,51,56,0,56
7604,False,41,42,20,0,20
7605,False,31,32,28,0,28
7606,False,11,12,15,0,15
7607,False,10,11,40,0,40
7608,False,47,48,25,1,24
7609,False,31,32,29,3,26
7610,False,2,3,1,0,1
7611,False,9,10,1,0,1
7612,False,19,20,2,0,2
7613,False,38,39,4,0,4
7614,False,18,19,28,0,28
7615,False,16,17,1,0,1
7616,False,29,30,11,0,11
7617,False,17,18,10,0,10
7618,False,52,53,18,0,18
7619,False,11,12,2,1,1
7620,False,8,9,2,1,1
7621,False,25,26,63,0,63
7622,False,36,37,17,0,17
7623,False,25,26,19,0,19
7624,False,62,63,36,0,36
7625,False,14,15,14,0,14
7626,False,19,20,25,0,25
7627,False,31,32,39,0,39
7628,False,21,22,10,0,10
7629,False,34,35,40,0,40
7630,False,47,48,120,2,118
7631,False,16,17,58,3,55
7632,False,81,82,34,0,34
7633,False,21,22,48,0,48
7634,False,62,63,33,3,30
7635,False,36,37,16,2,14
7636,False,6,7,3,0,3
7637,False,8,9,5,3,2
7638,False,29,30,18,0,18
7639,False,25,26,44,0,44
7640,False,26,27,55,0,55
7641,False,24,25,37,1,36
7642,False,19,20,34,0,34
7643,False,37,38,19,0,19
7644,False,45,46,28,2,26
7645,False,31,32,33,0,33
7646,False,6,7,26,0,26
7647,False,20,21,45,1,44
7648,False,23,24,10,0,10
7649,False,16,17,13,0,13
7650,False,30,31,60,1,59
7651,False,17,18,9,0,9
7652,False,11,12,30,7,23
7653,False,19,20,10,0,10
7654,False,15,16,53,8,45
7655,False,17,18,43,3,40
7656,False,37,38,45,0,45
7657,False,31,32,16,0,16
7658,False,41,42,11,0,11
7659,False,9,10,6,0,6
7660,False,16,17,90,4,86
7661,False,31,32,13,0,13
7662,False,34,35,15,2,13
7663,False,8,9,3,1,2
7664,False,24,25,15,1,14
7665,False,41,42,26,1,25
7666,False,40,41,28,0,28
7667,False,98,99,57,0,57
7668,False,35,36,22,0,22
7669,False,7,8,5,0,5
7670,False,7,8,1,0,1
7671,False,19,20,13,0,13
7672,False,34,35,13,0,13
7673,False,25,26,65,2,63
7674,False,9,10,6,0,6
7675,False,9,10,6,0,6
7676,False,65,66,61,1,60
7677,False,8,9,14,1,13
7678,False,16,17,9,0,9
7679,False,69,70,132,0,132
7680,False,62,63,46,1,45
7681,False,9,10,8,0,8
7682,False,22,23,29,2,27
7683,False,6,7,58,0,58
7684,False,45,46,39,0,39
7685,False,21,22,47,2,45
7686,False,68,69,28,1,27
7687,False,16,17,10,1,9
7688,False,47,48,29,0,29
7689,False,27,28,58,0,58
7690,False,17,18,44,1,43
7691,False,20,21,10,0,10
7692,False,15,16,13,0,13
7693,False,52,53,10,0,10
7694,False,53,54,41,3,38
7695,False,31,32,13,0,13
7696,False,32,33,29,2,27
7697,False,24,25,18,0,18
7698,False,54,55,33,1,32
7699,False,32,33,72,0,72
7700,False,18,19,9,0,9
7701,False,108,109,98,0,98
7702,False,75,76,101,1,100
7703,False,46,47,41,1,40
7704,False,28,29,32,0,32
7705,False,45,46,98,4,94
7706,False,12,13,15,0,15
7707,False,13,14,34,2,32
7708,False,48,49,11,1,10
7709,False,22,23,16,0,16
7710,False,19,20,18,0,18
7711,False,1,2,83,0,83
7712,False,21,22,28,0,28
7713,False,69,70,66,1,65
7714,False,6,7,3,0,3
7715,False,2,3,1,0,1
7716,False,56,57,41,4,37
7717,False,15,16,12,0,12
7718,False,26,27,57,1,56
7719,False,28,29,34,1,33
7720,False,6,7,0,0,0
7721,False,58,59,67,0,67
7722,False,27,28,17,0,17
7723,False,14,15,41,0,41
7724,False,6,7,2,0,2
7725,False,37,38,40,0,40
7726,False,10,11,7,0,7
7727,False,26,27,54,0,54
7728,False,13,14,8,2,6
7729,False,29,30,37,1,36
7730,False,4,5,4,0,4
7731,False,19,20,31,1,30
7732,False,12,13,5,0,5
7733,False,38,39,13,2,11
7734,False,37,38,26,0,26
7735,False,106,107,42,2,40
7736,False,37,38,25,0,25
7737,False,32,33,11,0,11
7738,False,24,25,19,0,19
7739,False,39,40,32,1,31
7740,False,29,30,8,0,8
7741,False,32,33,44,0,44
7742,False,23,24,19,0,19
7743,False,35,36,70,0,70
7744,False,16,17,8,0,8
7745,False,1,2,5,0,5
7746,False,55,56,57,2,55
7747,False,10,11,3,0,3
7748,False,17,18,7,0,7
7749,False,29,30,32,0,32
7750,False,22,23,5,0,5
7751,False,29,30,25,0,25
7752,False,15,16,11,0,11
7753,False,42,43,35,0,35
7754,False,31,32,38,0,38
7755,False,10,11,7,0,7
7756,False,33,34,12,0,12
7757,False,19,20,19,0,19
7758,False,11,12,2,0,2
7759,False,23,24,19,0,19
7760,False,28,29,31,1,30
7761,False,16,17,13,0,13
7762,False,61,62,55,2,53
7763,False,51,52,20,0,20
7764,False,14,15,27,0,27
7765,False,13,14,7,0,7
7766,False,50,51,27,0,27
7767,False,17,18,4,0,4
7768,False,70,71,72,0,72
7769,False,27,28,10,0,10
7770,False,51,52,56,0,56
7771,False,19,20,15,0,15
7772,False,12,13,6,0,6
7773,False,12,13,38,6,32
7774,False,26,27,37,0,37
7775,False,34,35,36,2,34
7776,False,12,13,13,1,12
7777,False,41,42,87,1,86
7778,False,13,14,9,0,9
7779,False,33,34,16,0,16
7780,False,52,53,32,0,32
7781,False,46,47,42,0,42
7782,False,58,59,40,0,40
7783,False,23,24,19,0,19
7784,False,50,51,40,1,39
7785,False,44,45,44,0,44
7786,False,30,31,21,0,21
7787,False,72,73,52,2,50
7788,False,9,10,23,0,23
7789,False,32,33,57,0,57
7790,False,21,22,24,1,23
7791,False,54,55,66,0,66
7792,False,28,29,40,0,40
7793,False,28,29,36,1,35
7794,False,38,39,40,0,40
7795,False,30,31,44,1,43
7796,False,36,37,39,2,37
7797,False,32,33,39,0,39
7798,False,8,9,2,0,2
7799,False,55,56,53,3,50
7800,False,15,16,7,0,7
7801,False,26,27,13,0,13
7802,False,49,50,28,0,28
7803,False,17,18,14,0,14
7804,False,7,8,4,0,4
7805,False,85,86,52,0,52
7806,False,30,31,18,0,18
7807,False,9,10,19,2,17
7808,False,38,39,44,0,44
7809,False,11,12,11,0,11
7810,False,34,35,52,1,51
7811,False,3,4,30,1,29
7812,False,28,29,20,0,20
7813,False,37,38,23,0,23
7814,False,16,17,48,0,48
7815,False,38,39,45,2,43
7816,False,27,28,44,0,44
7817,False,17,18,5,0,5
7818,False,16,17,9,0,9
7819,False,15,16,32,1,31
7820,False,32,33,23,0,23
7821,False,31,32,23,0,23
7822,False,48,49,27,3,24
7823,False,21,22,25,2,23
7824,False,24,25,38,1,37
7825,False,13,14,3,0,3
7826,False,1,2,2,0,2
7827,False,12,13,5,0,5
7828,False,39,40,34,0,34
7829,False,9,10,6,2,4
7830,False,9,10,24,9,15
7831,False,12,13,10,0,10
7832,False,35,36,23,0,23
7833,False,34,35,23,0,23
7834,False,26,27,40,0,40
7835,False,21,22,8,0,8
7836,False,5,6,10,0,10
7837,False,10,11,9,0,9
7838,False,10,11,6,0,6
7839,False,21,22,17,0,17
7840,False,40,41,30,2,28
7841,False,34,35,35,1,34
7842,False,18,19,11,1,10
7843,False,29,30,50,1,49
7844,False,19,20,13,0,13
7845,False,29,30,22,0,22
7846,False,22,23,36,0,36
7847,False,4,5,4,0,4
7848,False,11,12,5,1,4
7849,False,37,38,48,0,48
7850,False,34,35,20,2,18
7851,False,33,34,20,0,20
7852,False,21,22,38,0,38
7853,False,46,47,24,0,24
7854,False,40,41,41,0,41
7855,False,83,84,50,0,50
7856,False,36,37,38,0,38
7857,False,10,11,13,0,13
7858,False,44,45,43,0,43
7859,False,13,14,10,0,10
7860,False,42,43,82,1,81
7861,False,37,38,28,0,28
7862,False,25,26,8,0,8
7863,False,20,21,6,1,5
7864,False,52,53,54,2,52
7865,False,6,7,8,0,8
7866,False,42,43,71,2,69
7867,False,24,25,26,0,26
7868,False,96,97,78,9,69
7869,False,27,28,38,0,38
7870,False,33,34,34,0,34
7871,False,37,38,30,0,30
7872,False,65,66,42,0,42
7873,False,29,30,9,0,9
7874,False,34,35,28,0,28
7875,False,10,11,2,0,2
7876,False,13,14,6,0,6
7877,False,35,36,35,0,35
7878,False,16,17,29,0,29
7879,False,34,35,32,0,32
7880,False,34,35,73,0,73
7881,False,49,50,73,0,73
7882,False,18,19,47,0,47
7883,False,39,40,30,0,30
7884,False,38,39,44,1,43
7885,False,21,22,13,0,13
7886,False,12,13,9,0,9
7887,False,38,39,36,1,35
7888,False,68,69,52,4,48
7889,False,22,23,24,0,24
7890,False,37,38,108,2,106
7891,False,12,13,4,0,4
7892,False,17,18,4,0,4
7893,False,69,70,16,1,15
7894,False,18,19,12,0,12
7895,False,27,28,32,0,32
7896,False,5,6,3,0,3
7897,False,76,77,46,0,46
7898,False,20,21,8,0,8
7899,False,10,11,23,0,23
7900,False,32,33,12,0,12
7901,False,16,17,5,0,5
7902,False,21,22,14,0,14
7903,False,45,46,50,2,48
7904,False,14,15,30,0,30
7905,False,13,14,6,0,6
7906,False,26,27,7,0,7
7907,False,8,9,4,0,4
7908,False,18,19,8,1,7
7909,False,47,48,17,0,17
7910,False,30,31,7,0,7
7911,False,45,46,12,2,10
7912,False,19,20,15,0,15
7913,False,15,16,37,1,36
7914,False,68,69,44,3,41
7915,False,29,30,29,0,29
7916,False,21,22,34,0,34
7917,False,19,20,11,0,11
7918,False,36,37,39,0,39
7919,False,8,9,8,0,8
7920,False,31,32,15,1,14
7921,False,35,36,65,0,65
7922,False,12,13,2,0,2
7923,False,50,51,57,2,55
7924,False,63,64,56,9,47
7925,False,20,21,32,1,31
7926,False,22,23,38,1,37
7927,False,26,27,12,0,12
7928,False,11,12,5,1,4
7929,False,35,36,55,1,54
7930,False,23,24,68,0,68
7931,False,19,20,72,0,72
7932,False,9,10,7,0,7
7933,False,7,8,1,0,1
7934,False,4,5,2,0,2
7935,False,35,36,31,0,31
7936,False,26,27,9,0,9
7937,False,25,26,12,0,12
7938,False,41,42,40,1,39
7939,False,37,38,77,3,74
7940,False,13,14,10,1,9
7941,False,31,32,33,0,33
7942,False,102,103,61,0,61
7943,False,18,19,40,2,38
7944,False,29,30,37,0,37
7945,False,14,15,10,1,9
7946,False,34,35,28,0,28
7947,False,23,24,11,0,11
7948,False,9,10,8,0,8
7949,False,18,19,45,0,45
7950,False,48,49,21,0,21
7951,False,2,3,2,0,2
7952,False,18,19,13,2,11
7953,False,23,24,23,1,22
7954,False,23,24,13,0,13
7955,False,25,26,36,0,36
7956,False,45,46,47,1,46
7957,False,34,35,55,1,54
7958,False,14,15,28,0,28
7959,False,37,38,19,0,19
7960,False,2,3,1,0,1
7961,False,21,22,27,0,27
7962,False,8,9,7,0,7
7963,False,11,12,1,0,1
7964,False,10,11,0,0,0
7965,False,8,9,7,3,4
7966,False,8,9,5,0,5
7967,False,25,26,39,0,39
7968,False,37,38,20,0,20
7969,False,23,24,44,0,44
7970,False,29,30,22,0,22
7971,False,68,69,56,0,56
7972,False,6,7,7,0,7
7973,False,35,36,43,0,43
7974,False,40,41,41,0,41
7975,False,19,20,6,0,6
7976,False,5,6,0,0,0
7977,False,41,42,22,1,21
7978,False,19,20,34,0,34
7979,False,57,58,45,0,45
7980,False,24,25,52,0,52
7981,False,46,47,25,1,24
7982,False,9,10,23,0,23
7983,False,12,13,11,0,11
7984,False,35,36,22,0,22
7985,False,28,29,10,0,10
7986,False,15,16,4,0,4
7987,False,8,9,1,0,1
7988,False,35,36,20,0,20
7989,False,24,25,12,0,12
7990,False,31,32,21,0,21
7991,False,6,7,1,0,1
7992,False,44,45,31,1,30
7993,False,29,30,53,0,53
7994,False,19,20,9,0,9
7995,False,40,41,36,0,36
7996,False,35,36,15,0,15
7997,False,15,16,15,4,11
7998,False,47,48,42,0,42
7999,False,6,7,6,0,6
8000,False,25,26,38,0,38
8001,False,66,67,61,0,61
8002,False,21,22,7,0,7
8003,False,23,24,11,0,11
8004,False,25,26,6,0,6
8005,False,41,42,49,0,49
8006,False,34,35,53,1,52
8007,False,24,25,17,0,17
8008,False,28,29,33,0,33
8009,False,18,19,5,0,5
8010,False,21,22,27,2,25
8011,False,22,23,13,0,13
8012,False,41,42,60,1,59
8013,False,59,60,36,1,35
8014,False,2,3,0,0,0
8015,False,9,10,6,0,6
8016,False,32,33,36,3,33
8017,False,12,13,30,0,30
8018,False,29,30,50,3,47
8019,False,43,44,1,0,1
8020,False,19,20,14,0,14
8021,False,5,6,3,0,3
8022,False,21,22,11,0,11
8023,False,33,34,17,0,17
8024,False,11,12,0,0,0
8025,False,13,14,17,2,15
8026,False,31,32,17,0,17
8027,False,9,10,4,0,4
8028,False,33,34,45,0,45
8029,False,41,42,67,1,66
8030,False,12,13,4,0,4
8031,False,38,39,37,0,37
8032,False,68,69,73,1,72
8033,False,10,11,2,1,1
8034,False,18,19,39,1,38
8035,False,17,18,34,0,34
8036,False,2,3,1,0,1
8037,False,33,34,28,1,27
8038,False,13,14,12,0,12
8039,False,24,25,16,0,16
8040,False,26,27,43,0,43
8041,False,30,31,20,0,20
8042,False,2,3,4,0,4
8043,False,15,16,8,0,8
8044,False,46,47,15,0,15
8045,False,21,22,33,5,28
8046,False,64,65,89,5,84
8047,False,16,17,5,0,5
8048,False,24,25,23,0,23
8049,False,35,36,39,4,35
8050,False,30,31,5,0,5
8051,False,51,52,45,0,45
8052,False,23,24,10,0,10
8053,False,27,28,8,0,8
8054,False,29,30,38,0,38
8055,False,14,15,6,0,6
8056,False,20,21,12,0,12
8057,False,26,27,17,0,17
8058,False,54,55,36,0,36
8059,False,20,21,12,0,12
8060,False,7,8,3,0,3
8061,False,23,24,39,0,39
8062,False,43,44,27,0,27
8063,False,20,21,4,0,4
8064,False,11,12,4,0,4
8065,False,29,30,19,0,19
8066,False,37,38,34,0,34
8067,False,51,52,54,0,54
8068,False,57,58,27,0,27
8069,False,23,24,19,0,19
8070,False,44,45,28,0,28
8071,False,8,9,27,0,27
8072,False,8,9,5,1,4
8073,False,32,33,62,0,62
8074,False,24,25,15,0,15
8075,False,27,28,98,0,98
8076,False,21,22,37,0,37
8077,False,4,5,5,0,5
8078,False,15,16,4,0,4
8079,False,27,28,77,0,77
8080,False,28,29,38,0,38
8081,False,20,21,33,0,33
8082,False,16,17,8,3,5
8083,False,36,37,9,0,9
8084,False,43,44,76,0,76
8085,False,64,65,43,1,42
8086,False,23,24,50,0,50
8087,False,13,14,12,0,12
8088,False,104,105,61,0,61
8089,False,12,13,11,0,11
8090,False,19,20,9,0,9
8091,False,49,50,46,0,46
8092,False,14,15,62,0,62
8093,False,8,9,1,0,1
8094,False,24,25,30,0,30
8095,False,59,60,73,2,71
8096,False,65,66,68,2,66
8097,False,46,47,28,1,27
8098,False,50,51,44,0,44
8099,False,20,21,16,0,16
8100,False,15,16,7,1,6
8101,False,13,14,28,0,28
8102,False,25,26,16,0,16
8103,False,46,47,38,0,38
8104,False,21,22,9,0,9
8105,False,11,12,7,0,7
8106,False,11,12,6,0,6
8107,False,27,28,22,0,22
8108,False,14,15,28,2,26
8109,False,19,20,6,0,6
8110,False,41,42,27,0,27
8111,False,20,21,9,0,9
8112,False,22,23,7,0,7
8113,False,13,14,13,0,13
8114,False,40,41,30,0,30
8115,False,19,20,8,0,8
8116,False,6,7,5,0,5
8117,False,20,21,15,0,15
8118,False,40,41,75,1,74
8119,False,64,65,51,0,51
8120,False,28,29,76,1,75
8121,False,11,12,30,12,18
8122,False,50,51,60,1,59
8123,False,11,12,10,1,9
8124,False,17,18,31,2,29
8125,False,34,35,59,0,59
8126,False,16,17,8,0,8
8127,False,10,11,1,0,1
8128,False,40,41,38,0,38
8129,False,37,38,28,2,26
8130,False,21,22,9,0,9
8131,False,30,31,16,0,16
8132,False,49,50,47,1,46
8133,False,22,23,50,0,50
8134,False,16,17,1,0,1
8135,False,26,27,40,1,39
8136,False,28,29,9,0,9
8137,False,12,13,51,0,51
8138,False,4,5,10,0,10
8139,False,25,26,23,0,23
8140,False,4,5,5,0,5
8141,False,37,38,83,2,81
8142,False,3,4,26,0,26
8143,False,11,12,19,1,18
8144,False,44,45,56,0,56
8145,False,57,58,24,0,24
8146,False,9,10,26,9,17
8147,False,18,19,21,0,21
8148,False,38,39,25,0,25
8149,False,19,20,42,1,41
8150,False,26,27,5,0,5
8151,False,25,26,23,0,23
8152,False,65,66,37,1,36
8153,False,18,19,15,0,15
8154,False,32,33,26,0,26
8155,False,31,32,18,0,18
8156,False,25,26,14,0,14
8157,False,30,31,16,0,16
8158,False,12,13,6,0,6
8159,False,51,52,23,0,23
8160,False,46,47,49,1,48
8161,False,21,22,32,0,32
8162,False,19,20,58,0,58
8163,False,18,19,0,0,0
8164,False,34,35,36,0,36
8165,False,13,14,9,0,9
8166,False,107,108,67,2,65
8167,False,33,34,19,0,19
8168,False,6,7,1,1,0
8169,False,10,11,39,1,38
8170,False,55,56,50,2,48
8171,False,23,24,7,0,7
8172,False,37,38,26,0,26
8173,False,18,19,16,0,16
8174,False,12,13,22,7,15
8175,False,21,22,6,0,6
8176,False,9,10,3,2,1
8177,False,32,33,13,0,13
8178,False,34,35,59,2,57
8179,False,46,47,35,0,35
8180,False,43,44,32,0,32
8181,False,28,29,37,0,37
8182,False,27,28,16,0,16
8183,False,12,13,1,0,1
8184,False,19,20,12,0,12
8185,False,4,5,4,0,4
8186,False,14,15,5,0,5
8187,False,19,20,41,1,40
8188,False,61,62,46,1,45
8189,False,34,35,49,2,47
8190,False,5,6,2,0,2
8191,False,15,16,42,0,42
8192,False,54,55,27,0,27
8193,False,10,11,17,1,16
8194,False,25,26,55,0,55
8195,False,42,43,48,0,48
8196,False,9,10,4,0,4
8197,False,36,37,25,1,24
8198,False,32,33,54,2,52
8199,False,34,35,22,0,22
8200,False,31,32,29,0,29
8201,False,16,17,10,0,10
8202,False,4,5,2,0,2
8203,False,22,23,8,0,8
8204,False,61,62,75,1,74
8205,False,42,43,56,2,54
8206,False,30,31,22,0,22
8207,False,56,57,57,1,56
8208,False,13,14,0,0,0
8209,False,19,20,10,0,10
8210,False,40,41,53,4,49
8211,False,92,93,76,0,76
8212,False,60,61,58,2,56
8213,False,28,29,11,0,11
8214,False,6,7,8,0,8
8215,False,24,25,13,0,13
8216,False,44,45,24,0,24
8217,False,36,37,35,2,33
8218,False,20,21,29,1,28
8219,False,16,17,5,0,5
8220,False,29,30,19,0,19
8221,False,77,78,50,0,50
8222,False,34,35,26,1,25
8223,False,5,6,1,0,1
8224,False,24,25,14,0,14
8225,False,12,13,23,9,14
8226,False,24,25,10,0,10
8227,False,32,33,9,0,9
8228,False,15,16,34,0,34
8229,False,36,37,25,0,25
8230,False,25,26,23,1,22
8231,False,11,12,8,0,8
8232,False,27,28,30,5,25
8233,False,14,15,5,1,4
8234,False,15,16,32,0,32
8235,False,4,5,3,0,3
8236,False,12,13,3,1,2
8237,False,39,40,6,0,6
8238,False,27,28,20,0,20
8239,False,5,6,8,0,8
8240,False,24,25,18,0,18
8241,False,65,66,29,0,29
8242,False,9,10,2,0,2
8243,False,22,23,8,0,8
8244,False,27,28,17,0,17
8245,False,19,20,12,0,12
8246,False,27,28,13,0,13
8247,False,12,13,3,0,3
8248,False,24,25,18,1,17
8249,False,28,29,38,1,37
8250,False,24,25,21,0,21
8251,False,17,18,15,0,15
8252,False,9,10,12,0,12
8253,False,28,29,17,1,16
8254,False,52,53,25,0,25
8255,False,40,41,33,0,33
8256,False,19,20,9,0,9
8257,False,27,28,11,0,11
8258,False,19,20,13,0,13
8259,False,21,22,40,0,40
8260,False,24,25,8,0,8
8261,False,5,6,5,0,5
8262,False,7,8,6,0,6
8263,False,36,37,29,0,29
8264,False,32,33,87,0,87
8265,False,48,49,79,1,78
8266,False,10,11,47,0,47
8267,False,5,6,0,0,0
8268,False,7,8,6,0,6
8269,False,9,10,26,0,26
8270,False,2,3,2,0,2
8271,False,12,13,8,3,5
8272,False,37,38,15,0,15
8273,False,14,15,38,0,38
8274,False,12,13,14,0,14
8275,False,25,26,45,0,45
8276,False,30,31,38,0,38
8277,False,38,39,39,0,39
8278,False,37,38,15,0,15
8279,False,35,36,31,2,29
8280,False,14,15,16,0,16
8281,False,28,29,27,0,27
8282,False,1,2,0,0,0
8283,False,47,48,27,0,27
8284,False,13,14,11,0,11
8285,False,8,9,3,0,3
8286,False,32,33,17,1,16
8287,False,50,51,38,0,38
8288,False,21,22,9,0,9
8289,False,30,31,16,0,16
8290,False,11,12,10,0,10
8291,False,74,75,41,0,41
8292,False,27,28,15,3,12
8293,False,13,14,10,0,10
8294,False,27,28,34,0,34
8295,False,74,75,58,1,57
8296,False,46,47,25,1,24
8297,False,19,20,33,0,33
8298,False,28,29,15,0,15
8299,False,32,33,38,0,38
8300,False,40,41,28,0,28
8301,False,53,54,45,0,45
8302,False,75,76,46,1,45
8303,False,8,9,33,0,33
8304,False,31,32,35,2,33
8305,False,32,33,12,0,12
8306,False,24,25,16,2,14
8307,False,27,28,22,1,21
8308,False,28,29,41,0,41
8309,False,63,64,51,2,49
8310,False,19,20,6,0,6
8311,False,35,36,40,0,40
8312,False,11,12,31,0,31
8313,False,15,16,30,2,28
8314,False,88,89,39,3,36
8315,False,36,37,19,6,13
8316,False,50,51,59,0,59
8317,False,40,41,39,0,39
8318,False,33,34,69,0,69
8319,False,19,20,30,0,30
8320,False,31,32,23,0,23
8321,False,26,27,17,0,17
8322,False,5,6,28,0,28
8323,False,46,47,45,0,45
8324,False,22,23,16,0,16
8325,False,10,11,6,0,6
8326,False,43,44,45,1,44
8327,False,14,15,13,5,8
8328,False,31,32,29,1,28
8329,False,25,26,41,0,41
8330,False,34,35,38,0,38
8331,False,10,11,31,1,30
8332,False,5,6,5,0,5
8333,False,62,63,76,0,76
8334,False,61,62,50,1,49
8335,False,18,19,13,0,13
8336,False,30,31,42,0,42
8337,False,24,25,67,2,65
8338,False,34,35,25,0,25
8339,False,15,16,40,3,37
8340,False,34,35,15,0,15
8341,False,48,49,19,0,19
8342,False,16,17,35,0,35
8343,False,8,9,10,0,10
8344,False,3,4,1,0,1
8345,False,8,9,48,2,46
8346,False,19,20,38,1,37
8347,False,35,36,27,0,27
8348,False,12,13,1,0,1
8349,False,15,16,38,0,38
8350,False,11,12,24,0,24
8351,False,5,6,25,0,25
8352,False,22,23,51,1,50
8353,False,12,13,19,0,19
8354,False,27,28,35,0,35
8355,False,27,28,34,0,34
8356,False,14,15,17,0,17
8357,False,20,21,24,0,24
8358,False,13,14,7,0,7
8359,False,35,36,63,2,61
8360,False,14,15,16,0,16
8361,False,22,23,15,0,15
8362,False,15,16,8,0,8
8363,False,15,16,36,0,36
8364,False,19,20,41,0,41
8365,False,19,20,16,0,16
8366,False,40,41,29,1,28
8367,False,47,48,15,0,15
8368,False,4,5,7,1,6
8369,False,11,12,7,3,4
8370,False,15,16,10,0,10
8371,False,20,21,11,0,11
8372,False,5,6,0,0,0
8373,False,41,42,27,0,27
8374,False,12,13,13,0,13
8375,False,15,16,37,0,37
8376,False,4,5,2,0,2
8377,False,29,30,17,0,17
8378,False,42,43,47,5,42
8379,False,26,27,26,0,26
8380,False,24,25,40,0,40
8381,False,41,42,44,1,43
8382,False,34,35,36,0,36
8383,False,14,15,35,1,34
8384,False,27,28,13,0,13
8385,False,40,41,22,0,22
8386,False,37,38,77,0,77
8387,False,7,8,1,0,1
8388,False,22,23,17,0,17
8389,False,30,31,34,2,32
8390,False,25,26,11,0,11
8391,False,33,34,38,0,38
8392,False,11,12,3,2,1
8393,False,2,3,5,1,4
8394,False,19,20,4,1,3
8395,False,43,44,21,0,21
8396,False,7,8,1,0,1
8397,False,3,4,1,0,1
8398,False,38,39,48,1,47
8399,False,19,20,26,2,24
8400,False,35,36,16,0,16
8401,False,14,15,28,0,28
8402,False,99,100,83,0,83
8403,False,45,46,17,1,16
8404,False,25,26,19,0,19
8405,False,35,36,17,1,16
8406,False,23,24,10,0,10
8407,False,10,11,29,0,29
8408,False,53,54,26,0,26
8409,False,17,18,29,0,29
8410,False,14,15,7,0,7
8411,False,27,28,39,0,39
8412,False,41,42,36,0,36
8413,False,46,47,55,0,55
8414,False,68,69,51,0,51
8415,False,32,33,66,0,66
8416,False,17,18,12,0,12
8417,False,8,9,24,0,24
8418,False,19,20,9,0,9
8419,False,8,9,6,4,2
8420,False,19,20,21,0,21
8421,False,26,27,18,0,18
8422,False,26,27,30,0,30
8423,False,15,16,31,0,31
8424,False,16,17,2,0,2
8425,False,59,60,82,1,81
8426,False,49,50,28,0,28
8427,False,45,46,55,0,55
8428,False,7,8,5,0,5
8429,False,36,37,16,0,16
8430,False,25,26,22,0,22
8431,False,8,9,1,1,0
8432,False,36,37,53,0,53
8433,False,24,25,6,1,5
8434,False,15,16,38,3,35
8435,False,31,32,25,0,25
8436,False,27,28,21,0,21
8437,False,58,59,124,0,124
8438,False,17,18,12,0,12
8439,False,27,28,55,3,52
8440,False,21,22,17,0,17
8441,False,11,12,10,0,10
8442,False,46,47,57,0,57
8443,False,33,34,39,1,38
8444,False,27,28,11,1,10
8445,False,9,10,11,5,6
8446,False,10,11,12,0,12
8447,False,12,13,3,0,3
8448,False,13,14,13,0,13
8449,False,22,23,16,0,16
8450,False,23,24,16,0,16
8451,False,25,26,16,0,16
8452,False,46,47,31,1,30
8453,False,11,12,12,0,12
8454,False,32,33,65,1,64
8455,False,41,42,19,0,19
8456,False,32,33,96,2,94
8457,False,37,38,26,0,26
8458,False,18,19,74,2,72
8459,False,19,20,29,0,29
8460,False,58,59,42,0,42
8461,False,58,59,68,3,65
8462,False,41,42,35,1,34
8463,False,45,46,53,0,53
8464,False,13,14,9,0,9
8465,False,25,26,8,0,8
8466,False,32,33,26,0,26
8467,False,48,49,30,1,29
8468,False,17,18,10,0,10
8469,False,12,13,2,2,0
8470,False,17,18,13,0,13
8471,False,28,29,15,1,14
8472,False,16,17,4,0,4
8473,False,19,20,18,0,18
8474,False,34,35,48,2,46
8475,False,22,23,4,0,4
8476,False,9,10,3,0,3
8477,False,10,11,5,0,5
8478,False,7,8,6,0,6
8479,False,23,24,29,0,29
8480,False,9,10,6,0,6
8481,False,7,8,3,0,3
8482,False,21,22,16,0,16
8483,False,45,46,34,0,34
8484,False,9,10,12,0,12
8485,False,46,47,45,1,44
8486,False,55,56,95,2,93
8487,False,14,15,11,0,11
8488,False,35,36,58,0,58
8489,False,30,31,26,1,25
8490,False,58,59,51,1,50
8491,False,40,41,21,0,21
8492,False,18,19,18,0,18
8493,False,23,24,17,0,17
8494,False,50,51,18,0,18
8495,False,25,26,43,0,43
8496,False,36,37,36,0,36
8497,False,6,7,5,0,5
8498,False,18,19,20,2,18
8499,False,20,21,27,3,24
8500,False,10,11,3,0,3
8501,False,13,14,52,0,52
8502,False,36,37,15,0,15
8503,False,29,30,11,0,11
8504,False,53,54,43,1,42
8505,False,16,17,12,0,12
8506,False,63,64,36,0,36
8507,False,35,36,28,3,25
8508,False,45,46,31,1,30
8509,False,29,30,18,0,18
8510,False,19,20,16,0,16
8511,False,23,24,34,0,34
8512,False,36,37,14,0,14
8513,False,72,73,90,17,73
8514,False,97,98,128,0,128
8515,False,31,32,17,0,17
8516,False,18,19,9,0,9
8517,False,38,39,28,0,28
8518,False,25,26,20,0,20
8519,False,29,30,13,0,13
8520,False,66,67,71,0,71
8521,False,16,17,52,0,52
8522,False,31,32,20,0,20
8523,False,23,24,23,0,23
8524,False,30,31,16,0,16
8525,False,11,12,6,0,6
8526,False,31,32,23,1,22
8527,False,27,28,31,0,31
8528,False,11,12,3,1,2
8529,False,12,13,44,1,43
8530,False,10,11,25,0,25
8531,False,4,5,5,0,5
8532,False,18,19,10,0,10
8533,False,30,31,14,0,14
8534,False,32,33,19,0,19
8535,False,23,24,13,0,13
8536,False,13,14,32,0,32
8537,False,17,18,18,0,18
8538,False,10,11,8,0,8
8539,False,11,12,7,0,7
8540,False,31,32,45,2,43
8541,False,9,10,5,0,5
8542,False,2,3,5,0,5
8543,False,22,23,92,0,92
8544,False,12,13,9,0,9
8545,False,13,14,5,1,4
8546,False,23,24,14,0,14
8547,False,13,14,3,1,2
8548,False,32,33,17,0,17
8549,False,7,8,2,0,2
8550,False,24,25,35,0,35
8551,False,25,26,34,0,34
8552,False,35,36,13,0,13
8553,False,49,50,66,4,62
8554,False,10,11,3,0,3
8555,False,9,10,10,0,10
8556,False,38,39,37,0,37
8557,False,13,14,2,1,1
8558,False,30,31,45,2,43
8559,False,1,2,12,0,12
8560,False,36,37,20,0,20
8561,False,59,60,26,2,24
8562,False,25,26,29,0,29
8563,False,10,11,11,0,11
8564,False,19,20,37,5,32
8565,False,16,17,36,0,36
8566,False,7,8,6,0,6
8567,False,27,28,24,1,23
8568,False,11,12,33,1,32
8569,False,16,17,36,1,35
8570,False,32,33,38,0,38
8571,False,28,29,45,1,44
8572,False,28,29,15,0,15
8573,False,8,9,34,2,32
8574,False,12,13,56,3,53
8575,False,12,13,9,1,8
8576,False,13,14,55,0,55
8577,False,19,20,10,0,10
8578,False,28,29,38,1,37
8579,False,21,22,27,1,26
8580,False,30,31,78,0,78
8581,False,18,19,2,0,2
8582,False,7,8,1,1,0
8583,False,17,18,53,0,53
8584,False,31,32,14,0,14
8585,False,25,26,6,0,6
8586,False,4,5,1,0,1
8587,False,13,14,8,0,8
8588,False,33,34,18,0,18
8589,False,29,30,44,0,44
8590,False,3,4,0,0,0
8591,False,64,65,39,1,38
8592,False,23,24,29,1,28
8593,False,44,45,55,10,45
8594,False,28,29,47,1,46
8595,False,35,36,12,0,12
8596,False,20,21,63,0,63
8597,False,14,15,12,0,12
8598,False,9,10,4,0,4
8599,False,22,23,22,0,22
8600,False,16,17,10,0,10
8601,False,43,44,49,1,48
8602,False,3,4,7,0,7
8603,False,10,11,5,0,5
8604,False,9,10,6,0,6
8605,False,27,28,32,1,31
8606,False,20,21,7,0,7
8607,False,31,32,28,0,28
8608,False,30,31,21,0,21
8609,False,38,39,54,0,54
8610,False,11,12,13,0,13
8611,False,42,43,37,0,37
8612,False,52,53,23,1,22
8613,False,10,11,4,0,4
8614,False,25,26,90,0,90
8615,False,36,37,19,1,18
8616,False,16,17,13,0,13
8617,False,111,112,109,14,95
8618,False,17,18,33,0,33
8619,False,79,80,71,0,71
8620,False,17,18,10,2,8
8621,False,19,20,16,0,16
8622,False,40,41,20,0,20
8623,False,50,51,54,14,40
8624,False,16,17,5,0,5
8625,False,6,7,6,0,6
8626,False,13,14,26,0,26
8627,False,50,51,60,0,60
8628,False,10,11,2,0,2
8629,False,25,26,20,0,20
8630,False,44,45,53,0,53
8631,False,9,10,15,2,13
8632,False,7,8,9,0,9
8633,False,10,11,3,0,3
8634,False,32,33,5,0,5
8635,False,15,16,8,3,5
8636,False,39,40,27,0,27
8637,False,17,18,23,0,23
8638,False,8,9,8,0,8
8639,False,11,12,8,0,8
8640,False,13,14,19,0,19
8641,False,7,8,35,0,35
8642,False,42,43,33,1,32
8643,False,26,27,43,1,42
8644,False,6,7,2,0,2
8645,False,24,25,12,0,12
8646,False,54,55,33,0,33
8647,False,22,23,9,0,9
8648,False,50,51,38,2,36
8649,False,20,21,51,3,48
8650,False,25,26,22,0,22
8651,False,26,27,9,0,9
8652,False,21,22,33,0,33
8653,False,4,5,4,0,4
8654,False,34,35,19,0,19
8655,False,11,12,27,0,27
8656,False,2,3,2,0,2
8657,False,14,15,55,2,53
8658,False,30,31,68,0,68
8659,False,23,24,33,0,33
8660,False,7,8,7,0,7
8661,False,11,12,6,0,6
8662,False,36,37,70,2,68
8663,False,28,29,22,0,22
8664,False,31,32,16,0,16
8665,False,10,11,43,1,42
8666,False,13,14,9,3,6
8667,False,9,10,9,0,9
8668,False,19,20,28,0,28
8669,False,27,28,11,0,11
8670,False,29,30,15,0,15
8671,False,38,39,43,1,42
8672,False,16,17,26,1,25
8673,False,4,5,0,0,0
8674,False,10,11,0,0,0
8675,False,7,8,1,0,1
8676,False,43,44,45,0,45
8677,False,39,40,48,0,48
8678,False,52,53,19,0,19
8679,False,58,59,54,0,54
8680,False,22,23,37,0,37
8681,False,14,15,6,1,5
8682,False,19,20,53,0,53
8683,False,28,29,17,0,17
8684,False,12,13,6,0,6
8685,False,64,65,62,0,62
8686,False,33,34,38,2,36
8687,False,63,64,39,0,39
8688,False,74,75,62,0,62
8689,False,18,19,44,1,43
8690,False,13,14,34,0,34
8691,False,10,11,10,0,10
8692,False,25,26,17,0,17
8693,False,31,32,36,0,36
8694,False,21,22,86,0,86
8695,False,21,22,7,0,7
8696,False,9,10,4,0,4
8697,False,16,17,19,0,19
8698,False,32,33,19,1,18
8699,False,37,38,55,0,55
8700,False,25,26,34,0,34
8701,False,9,10,11,0,11
8702,False,15,16,8,0,8
8703,False,15,16,21,0,21
8704,False,11,12,6,1,5
8705,False,26,27,29,0,29
8706,False,35,36,19,2,17
8707,False,25,26,51,0,51
8708,False,34,35,32,2,30
8709,False,7,8,8,0,8
8710,False,14,15,10,1,9
8711,False,8,9,7,0,7
8712,False,18,19,14,0,14
8713,False,21,22,17,0,17
8714,False,24,25,26,0,26
8715,False,39,40,14,0,14
8716,False,43,44,40,1,39
8717,False,11,12,12,1,11
8718,False,13,14,54,0,54
8719,False,7,8,11,0,11
8720,False,35,36,45,0,45
8721,False,50,51,83,0,83
8722,False,18,19,13,0,13
8723,False,63,64,57,0,57
8724,False,5,6,8,0,8
8725,False,2,3,2,0,2
8726,False,49,50,0,0,0
8727,False,27,28,14,0,14
8728,False,48,49,46,0,46
8729,False,48,49,25,1,24
8730,False,13,14,6,0,6
8731,False,8,9,16,0,16
8732,False,38,39,82,2,80
8733,False,10,11,3,0,3
8734,False,38,39,19,0,19
8735,False,13,14,17,0,17
8736,False,10,11,25,0,25
8737,False,33,34,43,0,43
8738,False,48,49,43,2,41
8739,False,15,16,29,0,29
8740,False,10,11,2,1,1
8741,False,17,18,16,0,16
8742,False,17,18,9,0,9
8743,False,14,15,8,0,8
8744,False,8,9,5,0,5
8745,False,23,24,15,1,14
8746,False,25,26,37,0,37
8747,False,31,32,18,0,18
8748,False,5,6,5,1,4
8749,False,18,19,13,0,13
8750,False,26,27,14,0,14
8751,False,30,31,20,0,20
8752,False,26,27,76,0,76
8753,False,9,10,2,0,2
8754,False,52,53,51,0,51
8755,False,24,25,14,0,14
8756,False,39,40,44,1,43
8757,False,11,12,37,0,37
8758,False,30,31,23,3,20
8759,False,66,67,38,7,31
8760,False,14,15,6,0,6
8761,False,7,8,4,0,4
8762,False,19,20,8,0,8
8763,False,18,19,14,0,14
8764,False,14,15,3,0,3
8765,False,32,33,23,0,23
8766,False,26,27,9,0,9
8767,False,23,24,9,0,9
8768,False,11,12,34,0,34
8769,False,13,14,2,0,2
8770,False,22,23,13,0,13
8771,False,4,5,3,0,3
8772,False,23,24,5,0,5
8773,False,8,9,4,0,4
8774,False,10,11,5,0,5
8775,False,54,55,45,1,44
8776,False,28,29,19,0,19
8777,False,63,64,26,0,26
8778,False,9,10,5,0,5
8779,False,28,29,11,1,10
8780,False,26,27,13,0,13
8781,False,52,53,26,1,25
8782,False,5,6,0,0,0
8783,False,28,29,95,0,95
8784,False,68,69,42,0,42
8785,False,17,18,35,0,35
8786,False,28,29,40,2,38
8787,False,20,21,76,1,75
8788,False,29,30,16,0,16
8789,False,15,16,24,2,22
8790,False,30,31,19,0,19
8791,False,35,36,55,0,55
8792,False,21,22,16,1,15
8793,False,27,28,11,0,11
8794,False,16,17,40,1,39
8795,False,22,23,6,1,5
8796,False,12,13,10,0,10
8797,False,12,13,4,0,4
8798,False,18,19,19,0,19
8799,False,10,11,2,0,2
8800,False,44,45,34,0,34
8801,False,20,21,21,0,21
8802,False,57,58,77,0,77
8803,False,12,13,23,0,23
8804,False,6,7,2,0,2
8805,False,47,48,53,0,53
8806,False,32,33,45,0,45
8807,False,26,27,19,2,17
8808,False,27,28,13,0,13
8809,False,19,20,14,2,12
8810,False,19,20,4,0,4
8811,False,13,14,25,3,22
8812,False,15,16,16,0,16
8813,False,15,16,2,0,2
8814,False,25,26,36,0,36
8815,False,16,17,16,0,16
8816,False,45,46,55,2,53
8817,False,13,14,5,0,5
8818,False,19,20,29,0,29
8819,False,18,19,19,1,18
8820,False,20,21,15,0,15
8821,False,39,40,33,1,32
8822,False,9,10,4,0,4
8823,False,61,62,49,1,48
8824,False,19,20,29,0,29
8825,False,8,9,3,0,3
8826,False,24,25,11,0,11
8827,False,20,21,4,0,4
8828,False,19,20,4,2,2
8829,False,15,16,37,0,37
8830,False,12,13,4,0,4
8831,False,13,14,28,0,28
8832,False,67,68,37,0,37
8833,False,6,7,1,0,1
8834,False,36,37,25,0,25
8835,False,11,12,11,0,11
8836,False,39,40,15,3,12
8837,False,23,24,14,0,14
8838,False,48,49,22,1,21
8839,False,14,15,12,0,12
8840,False,7,8,4,0,4
8841,False,11,12,5,0,5
8842,False,6,7,30,0,30
8843,False,21,22,10,0,10
8844,False,6,7,5,0,5
8845,False,7,8,2,0,2
8846,False,7,8,9,0,9
8847,False,18,19,29,0,29
8848,False,21,22,12,0,12
8849,False,42,43,16,0,16
8850,False,29,30,44,1,43
8851,False,54,55,30,0,30
8852,False,33,34,41,1,40
8853,False,18,19,37,0,37
8854,False,42,43,53,0,53
8855,False,22,23,29,0,29
8856,False,6,7,1,0,1
8857,False,30,31,60,0,60
8858,False,10,11,8,0,8
8859,False,42,43,85,0,85
8860,False,8,9,25,1,24
8861,False,51,52,51,1,50
8862,False,10,11,4,0,4
8863,False,22,23,14,0,14
8864,False,5,6,1,0,1
8865,False,30,31,33,0,33
8866,False,22,23,13,2,11
8867,False,24,25,12,0,12
8868,False,16,17,10,1,9
8869,False,23,24,10,0,10
8870,False,23,24,36,0,36
8871,False,14,15,46,0,46
8872,False,35,36,23,0,23
8873,False,65,66,72,0,72
8874,False,46,47,62,0,62
8875,False,40,41,24,0,24
8876,False,27,28,9,0,9
8877,False,25,26,16,0,16
8878,False,16,17,8,1,7
8879,False,6,7,5,0,5
8880,False,9,10,3,0,3
8881,False,40,41,20,2,18
8882,False,39,40,50,0,50
8883,False,20,21,58,1,57
8884,False,45,46,20,0,20
8885,False,19,20,27,0,27
8886,False,8,9,1,0,1
8887,False,29,30,55,2,53
8888,False,37,38,46,0,46
8889,False,5,6,10,1,9
8890,False,24,25,15,0,15
8891,False,44,45,70,0,70
8892,False,21,22,13,1,12
8893,False,64,65,23,3,20
8894,False,19,20,7,0,7
8895,False,76,77,44,0,44
8896,False,30,31,14,0,14
8897,False,37,38,104,2,102
8898,False,12,13,6,0,6
8899,False,8,9,7,0,7
8900,False,30,31,16,0,16
8901,False,13,14,20,0,20
8902,False,23,24,38,3,35
8903,False,17,18,15,2,13
8904,False,41,42,65,3,62
8905,False,28,29,5,0,5
8906,False,45,46,71,2,69
8907,False,31,32,36,1,35
8908,False,7,8,6,0,6
8909,False,26,27,12,0,12
8910,False,21,22,18,0,18
8911,False,6,7,1,0,1
8912,False,13,14,10,0,10
8913,False,10,11,2,0,2
8914,False,24,25,15,0,15
8915,False,81,82,45,0,45
8916,False,46,47,31,1,30
8917,False,15,16,2,0,2
8918,False,7,8,4,0,4
8919,False,19,20,5,1,4
8920,False,26,27,61,0,61
8921,False,46,47,23,1,22
8922,False,18,19,31,0,31
8923,False,11,12,29,0,29
8924,False,31,32,14,0,14
8925,False,30,31,17,1,16
8926,False,6,7,7,0,7
8927,False,19,20,23,0,23
8928,False,33,34,17,0,17
8929,False,12,13,6,0,6
8930,False,33,34,63,0,63
8931,False,33,34,34,0,34
8932,False,29,30,18,1,17
8933,False,11,12,6,0,6
8934,False,22,23,8,0,8
8935,False,45,46,82,3,79
8936,False,11,12,4,2,2
8937,False,35,36,48,1,47
8938,False,42,43,48,0,48
8939,False,24,25,38,0,38
8940,False,36,37,9,2,7
8941,False,28,29,19,0,19
8942,False,12,13,4,0,4
8943,False,39,40,15,0,15
8944,False,11,12,2,0,2
8945,False,59,60,38,0,38
8946,False,13,14,8,0,8
8947,False,21,22,43,0,43
8948,False,23,24,49,0,49
8949,False,36,37,14,1,13
8950,False,6,7,36,4,32
8951,False,17,18,17,0,17
8952,False,25,26,14,0,14
8953,False,21,22,14,1,13
8954,False,22,23,19,0,19
8955,False,24,25,16,0,16
8956,False,15,16,38,0,38
8957,False,58,59,50,1,49
8958,False,11,12,12,1,11
8959,False,15,16,45,0,45
8960,False,19,20,15,0,15
8961,False,10,11,2,0,2
8962,False,30,31,30,1,29
8963,False,11,12,10,1,9
8964,False,17,18,4,0,4
8965,False,21,22,9,0,9
8966,False,10,11,31,0,31
8967,False,66,67,25,1,24
8968,False,13,14,43,2,41
8969,False,22,23,28,0,28
8970,False,22,23,10,0,10
8971,False,33,34,38,0,38
8972,False,47,48,49,1,48
8973,False,6,7,0,0,0
8974,False,22,23,49,0,49
8975,False,23,24,4,0,4
8976,False,14,15,4,0,4
8977,False,31,32,38,0,38
8978,False,64,65,137,0,137
8979,False,60,61,65,0,65
8980,False,6,7,4,0,4
8981,False,16,17,6,0,6
8982,False,36,37,31,0,31
8983,False,51,52,33,0,33
8984,False,18,19,11,0,11
8985,False,11,12,3,0,3
8986,False,8,9,23,1,22
8987,False,8,9,26,0,26
8988,False,23,24,17,2,15
8989,False,15,16,10,1,9
8990,False,15,16,9,1,8
8991,False,14,15,7,2,5
8992,False,40,41,42,4,38
8993,False,75,76,49,9,40
8994,False,15,16,5,1,4
8995,False,18,19,20,0,20
8996,False,10,11,17,0,17
8997,False,29,30,46,0,46
8998,False,13,14,10,0,10
8999,False,12,13,11,0,11
9000,False,23,24,13,0,13
9001,False,6,7,7,0,7
9002,False,39,40,39,0,39
9003,False,11,12,5,0,5
9004,False,15,16,7,0,7
9005,False,33,34,27,0,27
9006,False,55,56,67,2,65
9007,False,26,27,19,0,19
9008,False,29,30,17,0,17
9009,False,22,23,28,1,27
9010,False,49,50,51,1,50
9011,False,17,18,4,0,4
9012,False,15,16,19,0,19
9013,False,32,33,18,0,18
9014,False,13,14,5,0,5
9015,False,34,35,10,0,10
9016,False,58,59,35,0,35
9017,False,15,16,11,0,11
9018,False,17,18,10,0,10
9019,False,28,29,28,0,28
9020,False,7,8,1,0,1
9021,False,10,11,0,0,0
9022,False,21,22,26,0,26
9023,False,16,17,19,0,19
9024,False,36,37,38,0,38
9025,False,9,10,4,1,3
9026,False,18,19,12,1,11
9027,False,63,64,35,0,35
9028,False,18,19,69,4,65
9029,False,17,18,6,0,6
9030,False,14,15,33,5,28
9031,False,18,19,33,0,33
9032,False,23,24,13,0,13
9033,False,4,5,0,0,0
9034,False,26,27,12,1,11
9035,False,56,57,37,0,37
9036,False,8,9,32,1,31
9037,False,23,24,29,0,29
9038,False,17,18,31,0,31
9039,False,25,26,34,0,34
9040,False,11,12,9,2,7
9041,False,63,64,110,2,108
9042,False,76,77,26,0,26
9043,False,61,62,42,0,42
9044,False,29,30,33,0,33
9045,False,21,22,10,0,10
9046,False,10,11,2,0,2
9047,False,16,17,29,1,28
9048,False,15,16,20,0,20
9049,False,43,44,14,4,10
9050,False,27,28,53,1,52
9051,False,29,30,37,0,37
9052,False,23,24,7,0,7
9053,False,7,8,5,0,5
9054,False,12,13,3,0,3
9055,False,34,35,11,3,8
9056,False,42,43,82,1,81
9057,False,28,29,43,3,40
9058,False,32,33,16,0,16
9059,False,12,13,1,0,1
9060,False,30,31,18,0,18
9061,False,26,27,33,0,33
9062,False,19,20,15,0,15
9063,False,18,19,39,0,39
9064,False,44,45,35,0,35
9065,False,23,24,43,0,43
9066,False,43,44,71,1,70
9067,False,1,2,6,0,6
9068,False,15,16,8,0,8
9069,False,8,9,0,0,0
9070,False,49,50,23,0,23
9071,False,68,69,110,4,106
9072,False,6,7,9,0,9
9073,False,6,7,54,5,49
9074,False,7,8,13,1,12
9075,False,29,30,52,0,52
9076,False,42,43,67,0,67
9077,False,25,26,53,0,53
9078,False,16,17,26,0,26
9079,False,24,25,10,0,10
9080,False,31,32,17,0,17
9081,False,21,22,22,0,22
9082,False,49,50,65,0,65
9083,False,14,15,17,0,17
9084,False,30,31,39,0,39
9085,False,40,41,23,0,23
9086,False,20,21,0,0,0
9087,False,11,12,2,1,1
9088,False,25,26,39,0,39
9089,False,4,5,4,0,4
9090,False,4,5,9,0,9
9091,False,24,25,33,0,33
9092,False,9,10,4,0,4
9093,False,33,34,24,0,24
9094,False,46,47,25,0,25
9095,False,30,31,32,0,32
9096,False,12,13,8,0,8
9097,False,19,20,32,0,32
9098,False,22,23,16,1,15
9099,False,19,20,15,0,15
9100,False,34,35,40,0,40
9101,False,13,14,57,0,57
9102,False,14,15,11,0,11
9103,False,11,12,13,1,12
9104,False,31,32,37,0,37
9105,False,30,31,20,1,19
9106,False,18,19,13,0,13
9107,False,22,23,9,0,9
9108,False,12,13,29,0,29
9109,False,33,34,21,0,21
9110,False,9,10,1,0,1
9111,False,6,7,7,0,7
9112,False,34,35,28,0,28
9113,False,10,11,5,0,5
9114,False,16,17,8,0,8
9115,False,25,26,14,0,14
9116,False,21,22,16,0,16
9117,False,28,29,14,0,14
9118,False,28,29,19,0,19
9119,False,9,10,28,0,28
9120,False,22,23,7,0,7
9121,False,36,37,16,0,16
9122,False,8,9,10,0,10
9123,False,8,9,10,0,10
9124,False,19,20,38,1,37
9125,False,32,33,22,0,22
9126,False,14,15,6,0,6
9127,False,20,21,12,0,12
9128,False,31,32,22,0,22
9129,False,53,54,44,0,44
9130,False,14,15,63,0,63
9131,False,25,26,13,0,13
9132,False,20,21,6,0,6
9133,False,12,13,4,1,3
9134,False,58,59,31,1,30
9135,False,5,6,3,0,3
9136,False,21,22,35,0,35
9137,False,35,36,11,1,10
9138,False,23,24,30,0,30
9139,False,51,52,74,0,74
9140,False,6,7,11,0,11
9141,False,3,4,2,0,2
9142,False,40,41,46,3,43
9143,False,8,9,11,0,11
9144,False,14,15,29,1,28
9145,False,20,21,13,0,13
9146,False,22,23,9,0,9
9147,False,17,18,0,0,0
9148,False,18,19,21,0,21
9149,False,51,52,60,0,60
9150,False,39,40,26,0,26
9151,False,23,24,12,0,12
9152,False,121,122,75,0,75
9153,False,73,74,53,1,52
9154,False,5,6,4,0,4
9155,False,17,18,11,1,10
9156,False,29,30,41,1,40
9157,False,14,15,0,0,0
9158,False,33,34,17,0,17
9159,False,12,13,6,0,6
9160,False,50,51,59,2,57
9161,False,11,12,76,0,76
9162,False,26,27,12,0,12
9163,False,42,43,43,2,41
9164,False,21,22,7,0,7
9165,False,12,13,30,0,30
9166,False,18,19,22,0,22
9167,False,16,17,10,0,10
9168,False,11,12,5,0,5
9169,False,23,24,39,0,39
9170,False,56,57,24,0,24
9171,False,31,32,15,0,15
9172,False,37,38,62,0,62
9173,False,93,94,35,0,35
9174,False,5,6,9,0,9
9175,False,20,21,21,0,21
9176,False,39,40,16,0,16
9177,False,44,45,37,0,37
9178,False,3,4,2,0,2
9179,False,37,38,40,0,40
9180,False,38,39,12,1,11
9181,False,10,11,2,0,2
9182,False,37,38,31,0,31
9183,False,47,48,13,0,13
9184,False,21,22,11,0,11
9185,False,25,26,13,0,13
9186,False,7,8,30,1,29
9187,False,18,19,34,0,34
9188,False,13,14,31,0,31
9189,False,16,17,11,0,11
9190,False,30,31,60,0,60
9191,False,8,9,7,0,7
9192,False,13,14,7,0,7
9193,False,21,22,25,0,25
9194,False,18,19,4,0,4
9195,False,9,10,4,0,4
9196,False,13,14,6,2,4
9197,False,18,19,16,0,16
9198,False,19,20,33,0,33
9199,False,27,28,22,0,22
9200,False,24,25,25,0,25
9201,False,11,12,11,0,11
9202,False,10,11,8,0,8
9203,False,17,18,24,3,21
9204,False,12,13,30,0,30
9205,False,30,31,18,0,18
9206,False,11,12,7,0,7
9207,False,4,5,1,0,1
9208,False,57,58,47,0,47
9209,False,19,20,17,0,17
9210,False,43,44,1,0,1
9211,False,17,18,0,0,0
9212,False,8,9,5,0,5
9213,False,58,59,36,0,36
9214,False,30,31,25,1,24
9215,False,18,19,9,0,9
9216,False,12,13,6,0,6
9217,False,35,36,30,0,30
9218,False,33,34,17,0,17
9219,False,21,22,26,1,25
9220,False,11,12,39,0,39
9221,False,52,53,33,2,31
9222,False,52,53,12,0,12
9223,False,9,10,4,0,4
9224,False,30,31,29,0,29
9225,False,22,23,44,1,43
9226,False,5,6,3,0,3
9227,False,11,12,51,0,51
9228,False,30,31,29,0,29
9229,False,26,27,23,2,21
9230,False,13,14,15,0,15
9231,False,12,13,58,6,52
9232,False,12,13,28,18,10
9233,False,16,17,34,0,34
9234,False,37,38,16,0,16
9235,False,6,7,3,0,3
9236,False,12,13,9,0,9
9237,False,27,28,55,1,54
9238,False,35,36,22,0,22
9239,False,33,34,50,0,50
9240,False,11,12,1,0,1
9241,False,11,12,44,1,43
9242,False,29,30,32,2,30
9243,False,14,15,16,0,16
9244,False,26,27,19,0,19
9245,False,31,32,71,5,66
9246,False,72,73,62,0,62
9247,False,45,46,44,0,44
9248,False,24,25,30,0,30
9249,False,22,23,18,0,18
9250,False,12,13,4,3,1
9251,False,14,15,48,0,48
9252,False,22,23,12,0,12
9253,False,65,66,68,2,66
9254,False,10,11,31,0,31
9255,False,19,20,13,0,13
9256,False,16,17,29,1,28
9257,False,10,11,10,0,10
9258,False,27,28,20,0,20
9259,False,13,14,12,0,12
9260,False,10,11,7,0,7
9261,False,70,71,40,0,40
9262,False,20,21,2,0,2
9263,False,15,16,28,0,28
9264,False,15,16,93,0,93
9265,False,37,38,67,2,65
9266,False,10,11,1,0,1
9267,False,12,13,3,0,3
9268,False,13,14,5,0,5
9269,False,11,12,9,0,9
9270,False,10,11,1,0,1
9271,False,23,24,9,0,9
9272,False,12,13,16,0,16
9273,False,13,14,9,2,7
9274,False,8,9,8,0,8
9275,False,12,13,6,0,6
9276,False,10,11,4,0,4
9277,False,7,8,2,0,2
9278,False,7,8,6,0,6
9279,False,106,107,157,3,154
9280,False,21,22,5,0,5
9281,False,47,48,30,0,30
9282,False,10,11,6,0,6
9283,False,18,19,4,0,4
9284,False,23,24,17,0,17
9285,False,34,35,59,0,59
9286,False,10,11,5,0,5
9287,False,10,11,30,0,30
9288,False,11,12,12,2,10
9289,False,41,42,10,0,10
9290,False,16,17,14,0,14
9291,False,34,35,42,3,39
9292,False,38,39,50,0,50
9293,False,27,28,20,0,20
9294,False,15,16,7,0,7
9295,False,19,20,62,1,61
9296,False,28,29,22,1,21
9297,False,35,36,14,0,14
9298,False,9,10,5,0,5
9299,False,15,16,34,0,34
9300,False,5,6,12,0,12
9301,False,20,21,54,0,54
9302,False,16,17,5,0,5
9303,False,32,33,37,0,37
9304,False,22,23,16,1,15
9305,False,40,41,31,0,31
9306,False,8,9,24,0,24
9307,False,17,18,35,0,35
9308,False,8,9,4,0,4
9309,False,26,27,30,0,30
9310,False,11,12,2,1,1
9311,False,3,4,109,0,109
9312,False,1,2,39,0,39
9313,False,17,18,16,0,16
9314,False,17,18,8,0,8
9315,False,22,23,13,0,13
9316,False,21,22,29,0,29
9317,False,22,23,40,0,40
9318,False,12,13,8,0,8
9319,False,49,50,19,0,19
9320,False,34,35,59,1,58
9321,False,25,26,35,2,33
9322,False,28,29,15,0,15
9323,False,25,26,11,0,11
9324,False,47,48,50,1,49
9325,False,55,56,28,0,28
9326,False,32,33,47,0,47
9327,False,21,22,35,0,35
9328,False,7,8,32,0,32
9329,False,21,22,24,1,23
9330,False,21,22,11,0,11
9331,False,33,34,20,0,20
9332,False,11,12,3,0,3
9333,False,11,12,7,0,7
9334,False,36,37,37,0,37
9335,False,17,18,28,0,28
9336,False,37,38,48,1,47
9337,False,10,11,6,0,6
9338,False,12,13,28,9,19
9339,False,14,15,0,0,0
9340,False,33,34,49,0,49
9341,False,7,8,8,0,8
9342,False,13,14,7,4,3
9343,False,41,42,21,0,21
9344,False,13,14,61,7,54
9345,False,9,10,7,1,6
9346,False,4,5,6,0,6
9347,False,11,12,9,0,9
9348,False,3,4,4,0,4
9349,False,13,14,15,0,15
9350,False,35,36,30,0,30
9351,False,28,29,45,0,45
9352,False,7,8,2,0,2
9353,False,27,28,9,0,9
9354,False,12,13,1,0,1
9355,False,3,4,1,0,1
9356,False,28,29,45,2,43
9357,False,13,14,3,0,3
9358,False,31,32,4,0,4
9359,False,35,36,68,2,66
9360,False,66,67,49,1,48
9361,False,19,20,38,0,38
9362,False,26,27,58,0,58
9363,False,23,24,34,0,34
9364,False,9,10,5,0,5
9365,False,5,6,10,0,10
9366,False,36,37,21,1,20
9367,False,45,46,28,0,28
9368,False,14,15,10,0,10
9369,False,25,26,19,0,19
9370,False,16,17,9,0,9
9371,False,10,11,11,0,11
9372,False,53,54,44,1,43
9373,False,5,6,7,0,7
9374,False,28,29,12,0,12
9375,False,57,58,28,1,27
9376,False,48,49,27,0,27
9377,False,56,57,47,0,47
9378,False,16,17,33,0,33
9379,False,18,19,29,0,29
9380,False,16,17,11,0,11
9381,False,16,17,9,0,9
9382,False,11,12,31,0,31
9383,False,11,12,4,2,2
9384,False,14,15,13,0,13
9385,False,20,21,13,0,13
9386,False,10,11,9,0,9
9387,False,30,31,42,0,42
9388,False,17,18,10,0,10
9389,False,8,9,5,0,5
9390,False,17,18,32,0,32
9391,False,15,16,50,0,50
9392,False,27,28,52,3,49
9393,False,16,17,5,0,5
9394,False,21,22,14,0,14
9395,False,21,22,11,0,11
9396,False,27,28,48,1,47
9397,False,13,14,17,0,17
9398,False,9,10,7,0,7
9399,False,5,6,4,0,4
9400,False,20,21,15,0,15
9401,False,49,50,94,1,93
9402,False,10,11,6,0,6
9403,False,12,13,4,0,4
9404,False,20,21,36,0,36
9405,False,15,16,16,0,16
9406,False,23,24,40,0,40
9407,False,11,12,2,0,2
9408,False,15,16,53,0,53
9409,False,9,10,66,0,66
9410,False,16,17,25,2,23
9411,False,22,23,70,1,69
9412,False,34,35,20,0,20
9413,False,17,18,14,0,14
9414,False,12,13,6,0,6
9415,False,20,21,5,1,4
9416,False,8,9,10,0,10
9417,False,13,14,5,0,5
9418,False,21,22,18,2,16
9419,False,23,24,19,0,19
9420,False,24,25,82,0,82
9421,False,74,75,77,1,76
9422,False,32,33,9,0,9
9423,False,14,15,6,0,6
9424,False,28,29,33,0,33
9425,False,11,12,4,0,4
9426,False,28,29,21,0,21
9427,False,17,18,8,0,8
9428,False,7,8,0,0,0
9429,False,17,18,34,0,34
9430,False,13,14,29,0,29
9431,False,27,28,23,0,23
9432,False,15,16,11,0,11
9433,False,36,37,23,0,23
9434,False,13,14,24,0,24
9435,False,34,35,63,1,62
9436,False,37,38,29,0,29
9437,False,21,22,12,0,12
9438,False,15,16,8,0,8
9439,False,38,39,14,0,14
9440,False,9,10,49,22,27
9441,False,1,2,4,0,4
9442,False,3,4,34,0,34
9443,False,12,13,8,0,8
9444,False,31,32,32,0,32
9445,False,24,25,10,0,10
9446,False,3,4,3,0,3
9447,False,15,16,47,2,45
9448,False,18,19,29,0,29
9449,False,21,22,12,0,12
9450,False,48,49,50,0,50
9451,False,36,37,19,0,19
9452,False,41,42,0,0,0
9453,False,16,17,0,0,0
9454,False,12,13,6,1,5
9455,False,32,33,16,0,16
9456,False,4,5,1,0,1
9457,False,6,7,24,2,22
9458,False,37,38,25,0,25
9459,False,14,15,4,0,4
9460,False,24,25,16,0,16
9461,False,18,19,11,0,11
9462,False,11,12,7,0,7
9463,False,43,44,69,1,68
9464,False,39,40,26,1,25
9465,False,28,29,9,0,9
9466,False,10,11,4,1,3
9467,False,12,13,8,1,7
9468,False,53,54,14,5,9
9469,False,10,11,3,0,3
9470,False,25,26,14,0,14
9471,False,14,15,21,0,21
9472,False,19,20,29,0,29
9473,False,11,12,9,0,9
9474,False,51,52,30,0,30
9475,False,43,44,38,0,38
9476,False,12,13,4,0,4
9477,False,28,29,13,0,13
9478,False,11,12,10,0,10
9479,False,6,7,2,0,2
9480,False,34,35,24,1,23
9481,False,48,49,52,0,52
9482,False,38,39,40,0,40
9483,False,8,9,7,1,6
9484,False,7,8,4,0,4
9485,False,20,21,17,0,17
9486,False,20,21,33,0,33
9487,False,11,12,5,0,5
9488,False,30,31,22,0,22
9489,False,36,37,33,0,33
9490,False,23,24,9,0,9
9491,False,32,33,25,0,25
9492,False,27,28,38,0,38
9493,False,7,8,8,1,7
9494,False,34,35,17,0,17
9495,False,23,24,13,0,13
9496,False,1,2,0,0,0
9497,False,22,23,62,1,61
9498,False,32,33,37,1,36
9499,False,16,17,5,0,5
9500,False,23,24,25,0,25
9501,False,39,40,101,2,99
9502,False,27,28,25,0,25
9503,False,27,28,36,0,36
9504,False,13,14,8,0,8
9505,False,45,46,57,0,57
9506,False,25,26,11,0,11
9507,False,31,32,34,0,34
9508,False,34,35,59,1,58
9509,False,13,14,9,1,8
9510,False,30,31,40,1,39
9511,False,33,34,19,0,19
9512,False,7,8,13,0,13
9513,False,17,18,21,0,21
9514,False,24,25,25,0,25
9515,False,9,10,0,0,0
9516,False,25,26,14,0,14
9517,False,39,40,62,1,61
9518,False,7,8,4,1,3
9519,False,21,22,7,1,6
9520,False,24,25,22,0,22
9521,False,39,40,48,0,48
9522,False,9,10,49,1,48
9523,False,25,26,14,0,14
9524,False,27,28,16,0,16
9525,False,24,25,20,1,19
9526,False,11,12,12,0,12
9527,False,20,21,35,0,35
9528,False,15,16,14,0,14
9529,False,19,20,55,0,55
9530,False,18,19,10,0,10
9531,False,10,11,24,3,21
9532,False,10,11,54,0,54
9533,False,18,19,44,0,44
9534,False,9,10,1,0,1
9535,False,28,29,14,0,14
9536,False,47,48,37,0,37
9537,False,37,38,26,0,26
9538,False,15,16,19,0,19
9539,False,17,18,9,0,9
9540,False,10,11,2,1,1
9541,False,12,13,1,0,1
9542,False,15,16,8,0,8
9543,False,33,34,22,1,21
9544,False,12,13,8,0,8
9545,False,28,29,42,0,42
9546,False,22,23,54,1,53
9547,False,11,12,38,0,38
9548,False,81,82,33,1,32
9549,False,16,17,10,0,10
9550,False,37,38,57,0,57
9551,False,23,24,14,0,14
9552,False,33,34,22,0,22
9553,False,30,31,25,1,24
9554,False,26,27,35,1,34
9555,False,10,11,29,1,28
9556,False,5,6,8,0,8
9557,False,14,15,6,0,6
9558,False,30,31,41,2,39
9559,False,61,62,30,0,30
9560,False,14,15,0,0,0
9561,False,33,34,12,0,12
9562,False,10,11,7,0,7
9563,False,23,24,4,0,4
9564,False,32,33,35,0,35
9565,False,28,29,11,0,11
9566,False,36,37,34,0,34
9567,False,43,44,68,0,68
9568,False,37,38,35,0,35
9569,False,23,24,11,0,11
9570,False,11,12,5,2,3
9571,False,17,18,7,0,7
9572,False,10,11,6,2,4
9573,False,20,21,14,0,14
9574,False,23,24,10,0,10
9575,False,11,12,0,0,0
9576,False,12,13,6,1,5
9577,False,6,7,1,0,1
9578,False,30,31,23,0,23
9579,False,52,53,47,2,45
9580,False,19,20,10,0,10
9581,False,24,25,14,0,14
9582,False,31,32,91,1,90
9583,False,8,9,3,0,3
9584,False,18,19,3,0,3
9585,False,18,19,11,0,11
9586,False,26,27,12,1,11
9587,False,10,11,49,0,49
9588,False,40,41,14,0,14
9589,False,18,19,5,0,5
9590,False,4,5,7,0,7
9591,False,23,24,10,0,10
9592,False,30,31,23,0,23
9593,False,20,21,8,1,7
9594,False,15,16,21,0,21
9595,False,28,29,79,4,75
9596,False,26,27,11,0,11
9597,False,11,12,5,1,4
9598,False,28,29,19,0,19
9599,False,32,33,18,0,18
9600,False,24,25,39,1,38
9601,False,8,9,7,1,6
9602,False,34,35,68,0,68
9603,False,8,9,25,1,24
9604,False,7,8,4,0,4
9605,False,13,14,7,0,7
9606,False,40,41,48,0,48
9607,False,20,21,24,0,24
9608,False,9,10,12,0,12
9609,False,19,20,21,0,21
9610,False,46,47,112,1,111
9611,False,32,33,44,1,43
9612,False,48,49,48,5,43
9613,False,31,32,14,0,14
9614,False,10,11,9,0,9
9615,False,9,10,32,2,30
9616,False,13,14,17,0,17
9617,False,11,12,8,0,8
9618,False,9,10,3,0,3
9619,False,32,33,47,0,47
9620,False,56,57,67,1,66
9621,False,32,33,15,0,15
9622,False,60,61,26,0,26
9623,False,15,16,31,0,31
9624,False,15,16,19,0,19
9625,False,64,65,39,0,39
9626,False,6,7,26,0,26
9627,False,9,10,14,5,9
9628,False,24,25,18,0,18
9629,False,25,26,18,0,18
9630,False,11,12,24,3,21
9631,False,29,30,18,1,17
9632,False,15,16,32,2,30
9633,False,13,14,40,4,36
9634,False,31,32,35,0,35
9635,False,19,20,0,0,0
9636,False,11,12,12,0,12
9637,False,13,14,4,0,4
9638,False,3,4,10,0,10
9639,False,7,8,5,0,5
9640,False,36,37,46,0,46
9641,False,42,43,21,0,21
9642,False,27,28,3,0,3
9643,False,21,22,41,0,41
9644,False,41,42,31,1,30
9645,False,21,22,21,0,21
9646,False,25,26,21,1,20
9647,False,4,5,1,0,1
9648,False,18,19,11,0,11
9649,False,19,20,32,0,32
9650,False,34,35,15,0,15
9651,False,20,21,22,0,22
9652,False,15,16,9,0,9
9653,False,11,12,13,0,13
9654,False,15,16,18,0,18
9655,False,28,29,11,0,11
9656,False,8,9,27,0,27
9657,False,19,20,4,0,4
9658,False,12,13,4,0,4
9659,False,23,24,10,0,10
9660,False,3,4,3,0,3
9661,False,57,58,36,0,36
9662,False,6,7,1,0,1
9663,False,20,21,15,0,15
9664,False,33,34,78,1,77
9665,False,30,31,16,0,16
9666,False,29,30,16,1,15
9667,False,34,35,48,0,48
9668,False,11,12,13,0,13
9669,False,15,16,2,0,2
9670,False,13,14,5,0,5
9671,False,15,16,12,0,12
9672,False,14,15,23,0,23
9673,False,41,42,29,0,29
9674,False,7,8,7,0,7
9675,False,8,9,5,0,5
9676,False,22,23,19,1,18
9677,False,17,18,13,0,13
9678,False,14,15,15,0,15
9679,False,11,12,4,1,3
9680,False,20,21,56,1,55
9681,False,47,48,15,0,15
9682,False,12,13,3,1,2
9683,False,24,25,43,0,43
9684,False,17,18,48,0,48
9685,False,6,7,0,0,0
9686,False,8,9,0,0,0
9687,False,11,12,6,1,5
9688,False,25,26,29,0,29
9689,False,16,17,7,0,7
9690,False,8,9,1,0,1
9691,False,16,17,24,10,14
9692,False,25,26,44,3,41
9693,False,13,14,21,0,21
9694,False,26,27,39,1,38
9695,False,14,15,11,0,11
9696,False,14,15,8,1,7
9697,False,21,22,12,0,12
9698,False,37,38,66,0,66
9699,False,4,5,3,0,3
9700,False,18,19,14,0,14
9701,False,32,33,23,0,23
9702,False,34,35,27,0,27
9703,False,28,29,27,2,25
9704,False,6,7,7,0,7
9705,False,6,7,4,0,4
9706,False,5,6,9,0,9
9707,False,16,17,7,0,7
9708,False,13,14,45,0,45
9709,False,12,13,11,0,11
9710,False,18,19,9,0,9
9711,False,8,9,13,0,13
9712,False,7,8,4,0,4
9713,False,40,41,53,1,52
9714,False,9,10,2,0,2
9715,False,20,21,10,0,10
9716,False,30,31,24,0,24
9717,False,20,21,32,1,31
9718,False,27,28,22,0,22
9719,False,20,21,4,0,4
9720,False,28,29,39,0,39
9721,False,30,31,89,0,89
9722,False,23,24,48,0,48
9723,False,10,11,57,0,57
9724,False,49,50,30,1,29
9725,False,21,22,37,0,37
9726,False,12,13,8,0,8
9727,False,23,24,15,0,15
9728,False,15,16,30,3,27
9729,False,9,10,4,2,2
9730,False,41,42,13,0,13
9731,False,53,54,31,1,30
9732,False,38,39,16,0,16
9733,False,10,11,34,0,34
9734,False,13,14,19,0,19
9735,False,14,15,4,0,4
9736,False,9,10,5,0,5
9737,False,23,24,19,1,18
9738,False,8,9,7,0,7
9739,False,12,13,29,0,29
9740,False,10,11,3,2,1
9741,False,1,2,1,0,1
9742,False,43,44,53,0,53
9743,False,22,23,25,0,25
9744,False,30,31,16,0,16
9745,False,47,48,45,1,44
9746,False,15,16,16,2,14
9747,False,14,15,17,0,17
9748,False,17,18,6,0,6
9749,False,34,35,32,0,32
9750,False,13,14,6,3,3
9751,False,4,5,4,0,4
9752,False,7,8,25,0,25
9753,False,14,15,14,0,14
9754,False,9,10,5,0,5
9755,False,30,31,20,0,20
9756,False,13,14,34,0,34
9757,False,12,13,12,2,10
9758,False,20,21,36,0,36
9759,False,16,17,60,0,60
9760,False,13,14,13,0,13
9761,False,14,15,2,0,2
9762,False,11,12,8,0,8
9763,False,23,24,41,0,41
9764,False,3,4,14,0,14
9765,False,21,22,41,3,38
9766,False,58,59,44,0,44
9767,False,19,20,10,0,10
9768,False,51,52,39,1,38
9769,False,37,38,25,0,25
9770,False,26,27,23,0,23
9771,False,19,20,14,0,14
9772,False,9,10,5,1,4
9773,False,29,30,18,0,18
9774,False,15,16,36,1,35
9775,False,12,13,17,0,17
9776,False,13,14,10,0,10
9777,False,8,9,3,0,3
9778,False,15,16,9,0,9
9779,False,14,15,13,0,13
9780,False,49,50,48,0,48
9781,False,30,31,35,0,35
9782,False,6,7,27,2,25
9783,False,28,29,46,3,43
9784,False,34,35,26,1,25
9785,False,17,18,9,0,9
9786,False,16,17,34,4,30
9787,False,16,17,12,0,12
9788,False,11,12,4,0,4
9789,False,10,11,34,0,34
9790,False,21,22,15,0,15
9791,False,27,28,31,0,31
9792,False,14,15,14,0,14
9793,False,19,20,35,1,34
9794,False,17,18,6,0,6
9795,False,21,22,50,0,50
9796,False,19,20,6,0,6
9797,False,32,33,15,2,13
9798,False,13,14,7,0,7
9799,False,11,12,11,0,11
9800,False,36,37,42,1,41
9801,False,17,18,5,0,5
9802,False,27,28,12,0,12
9803,False,22,23,18,0,18
9804,False,11,12,30,0,30
9805,False,6,7,7,0,7
9806,False,28,29,40,0,40
9807,False,5,6,18,1,17
9808,False,17,18,9,0,9
9809,False,68,69,90,4,86
9810,False,31,32,52,0,52
9811,False,35,36,28,0,28
9812,False,17,18,9,0,9
9813,False,39,40,21,0,21
9814,False,17,18,33,0,33
9815,False,32,33,12,0,12
9816,False,9,10,59,7,52
9817,False,9,10,7,0,7
9818,False,17,18,1,0,1
9819,False,3,4,0,0,0
9820,False,13,14,34,0,34
9821,False,31,32,20,1,19
9822,False,14,15,26,0,26
9823,False,41,42,42,0,42
9824,False,24,25,15,0,15
9825,False,25,26,34,1,33
9826,False,19,20,2,0,2
9827,False,42,43,24,1,23
9828,False,7,8,13,0,13
9829,False,16,17,14,0,14
9830,False,25,26,20,1,19
9831,False,20,21,22,0,22
9832,False,14,15,3,0,3
9833,False,1,2,3,0,3
9834,False,41,42,24,0,24
9835,False,7,8,4,0,4
9836,False,17,18,23,0,23
9837,False,21,22,9,0,9
9838,False,31,32,16,0,16
9839,False,20,21,12,0,12
9840,False,15,16,2,0,2
9841,False,19,20,14,0,14
9842,False,30,31,23,1,22
9843,False,2,3,13,0,13
9844,False,22,23,37,1,36
9845,False,10,11,33,0,33
9846,False,16,17,10,0,10
9847,False,26,27,35,0,35
9848,False,10,11,6,0,6
9849,False,25,26,34,3,31
9850,False,30,31,32,0,32
9851,False,17,18,14,0,14
9852,False,21,22,11,0,11
9853,False,7,8,6,0,6
9854,False,16,17,34,0,34
9855,False,21,22,33,0,33
9856,False,9,10,7,0,7
9857,False,21,22,10,0,10
9858,False,57,58,18,3,15
9859,False,52,53,60,1,59
9860,False,11,12,8,0,8
9861,False,9,10,2,0,2
9862,False,8,9,7,0,7
9863,False,15,16,18,1,17
9864,False,35,36,27,0,27
9865,False,22,23,11,0,11
9866,False,14,15,3,0,3
9867,False,30,31,24,0,24
9868,False,29,30,22,0,22
9869,False,14,15,14,0,14
9870,False,25,26,10,0,10
9871,False,30,31,40,0,40
9872,False,37,38,48,4,44
9873,False,30,31,48,0,48
9874,False,17,18,66,0,66
9875,False,7,8,37,0,37
9876,False,42,43,51,0,51
9877,False,34,35,22,0,22
9878,False,32,33,49,0,49
9879,False,15,16,12,0,12
9880,False,31,32,71,2,69
9881,False,62,63,25,0,25
9882,False,13,14,5,0,5
9883,False,11,12,33,0,33
9884,False,14,15,13,0,13
9885,False,10,11,3,0,3
9886,False,10,11,25,0,25
9887,False,32,33,27,0,27
9888,False,34,35,9,1,8
9889,False,52,53,37,0,37
9890,False,26,27,23,0,23
9891,False,20,21,17,0,17
9892,False,10,11,6,0,6
9893,False,35,36,16,0,16
9894,False,4,5,15,3,12
9895,False,26,27,39,0,39
9896,False,14,15,25,0,25
9897,False,3,4,3,0,3
9898,False,25,26,48,4,44
9899,False,17,18,8,0,8
9900,False,31,32,18,0,18
9901,False,32,33,90,1,89
9902,False,24,25,16,0,16
9903,False,30,31,23,0,23
9904,False,12,13,4,0,4
9905,False,33,34,23,0,23
9906,False,30,31,21,0,21
9907,False,14,15,88,1,87
9908,False,66,67,21,2,19
9909,False,11,12,1,0,1
9910,False,14,15,28,0,28
9911,False,30,31,47,0,47
9912,False,33,34,56,0,56
9913,False,5,6,3,0,3
9914,False,10,11,10,4,6
9915,False,12,13,0,0,0
9916,False,19,20,6,0,6
9917,False,23,24,8,1,7
9918,False,26,27,23,0,23
9919,False,46,47,48,4,44
9920,False,8,9,5,0,5
9921,False,26,27,14,0,14
9922,False,2,3,2,0,2
9923,False,15,16,4,0,4
9924,False,2,3,2,0,2
9925,False,15,16,6,0,6
9926,False,7,8,1,1,0
9927,False,13,14,5,0,5
9928,False,22,23,11,1,10
9929,False,54,55,38,0,38
9930,False,13,14,10,0,10
9931,False,13,14,6,0,6
9932,False,22,23,12,0,12
9933,False,8,9,14,0,14
9934,False,8,9,12,0,12
9935,False,32,33,69,3,66
9936,False,25,26,53,1,52
9937,False,23,24,32,0,32
9938,False,7,8,3,0,3
9939,False,17,18,68,0,68
9940,False,23,24,74,2,72
9941,False,10,11,5,0,5
9942,False,10,11,9,0,9
9943,False,16,17,13,0,13
9944,False,24,25,6,0,6
9945,False,34,35,38,0,38
9946,False,13,14,7,0,7
9947,False,12,13,29,1,28
9948,False,9,10,5,0,5
9949,False,4,5,1,0,1
9950,False,8,9,7,0,7
9951,False,13,14,27,0,27
9952,False,18,19,8,0,8
9953,False,7,8,25,1,24
9954,False,28,29,20,0,20
9955,False,15,16,31,1,30
9956,False,23,24,18,1,17
9957,False,27,28,6,0,6
9958,False,11,12,4,0,4
9959,False,51,52,32,1,31
9960,False,16,17,27,0,27
9961,False,44,45,43,0,43
9962,False,5,6,33,4,29
9963,False,26,27,29,0,29
9964,False,20,21,6,0,6
9965,False,20,21,30,1,29
9966,False,35,36,57,2,55
9967,False,10,11,2,0,2
9968,False,19,20,5,0,5
9969,False,35,36,29,2,27
9970,False,3,4,8,0,8
9971,False,16,17,30,0,30
9972,False,13,14,14,0,14
9973,False,20,21,4,1,3
9974,False,7,8,6,0,6
9975,False,4,5,1,0,1
9976,False,6,7,4,1,3
9977,False,27,28,7,0,7
9978,False,14,15,13,0,13
9979,False,62,63,25,0,25
9980,False,25,26,14,0,14
9981,False,8,9,4,0,4
9982,False,57,58,39,3,36
9983,False,39,40,10,0,10
9984,False,26,27,14,0,14
9985,False,14,15,2,0,2
9986,False,11,12,3,0,3
9987,False,6,7,38,1,37
9988,False,33,34,36,1,35
9989,False,5,6,1,0,1
9990,False,27,28,25,0,25
9991,False,23,24,16,0,16
9992,False,14,15,4,0,4
9993,False,8,9,6,0,6
9994,False,38,39,37,0,37
9995,False,28,29,7,0,7
9996,False,19,20,33,0,33
9997,False,19,20,11,0,11
9998,False,14,15,3,0,3
9999,False,33,34,15,0,15
10000,False,11,12,3,0,3
10001,False,12,13,2,0,2
10002,False,34,35,34,4,30
10003,False,9,10,2,0,2
10004,False,27,28,15,0,15
10005,False,8,9,4,0,4
10006,False,7,8,2,0,2
10007,False,14,15,2,0,2
10008,False,8,9,5,0,5
10009,False,30,31,10,0,10
10010,False,32,33,18,0,18
10011,False,41,42,17,0,17
10012,False,14,15,6,0,6
10013,False,8,9,4,1,3
10014,False,15,16,10,0,10
10015,False,14,15,12,0,12
10016,False,34,35,27,1,26
10017,False,15,16,7,0,7
10018,False,44,45,32,0,32
10019,False,40,41,68,1,67
10020,False,38,39,74,3,71
10021,False,5,6,3,0,3
10022,False,26,27,68,2,66
10023,False,8,9,5,1,4
10024,False,9,10,0,0,0
10025,False,34,35,43,2,41
10026,False,13,14,2,0,2
10027,False,3,4,2,0,2
10028,False,11,12,6,0,6
10029,False,19,20,26,0,26
10030,False,6,7,12,0,12
10031,False,7,8,13,1,12
10032,False,28,29,16,1,15
10033,False,8,9,12,0,12
10034,False,6,7,0,0,0
10035,False,37,38,12,0,12
10036,False,37,38,64,0,64
10037,False,19,20,12,0,12
10038,False,12,13,13,0,13
10039,False,11,12,9,0,9
10040,False,7,8,14,0,14
10041,False,10,11,5,0,5
10042,False,12,13,13,0,13
10043,False,18,19,8,0,8
10044,False,13,14,31,0,31
10045,False,28,29,13,0,13
10046,False,24,25,34,0,34
10047,False,17,18,33,0,33
10048,False,25,26,35,1,34
10049,False,8,9,5,0,5
10050,False,10,11,8,0,8
10051,False,31,32,23,0,23
10052,False,21,22,17,2,15
10053,False,10,11,31,0,31
10054,False,7,8,1,0,1
10055,False,7,8,33,0,33
10056,False,22,23,14,0,14
10057,False,9,10,11,0,11
10058,False,14,15,5,2,3
10059,False,41,42,45,0,45
10060,False,14,15,13,0,13
10061,False,10,11,3,1,2
10062,False,8,9,1,0,1
10063,False,10,11,14,0,14
10064,False,11,12,32,2,30
10065,False,36,37,39,0,39
10066,False,7,8,2,1,1
10067,False,15,16,35,1,34
10068,False,39,40,27,0,27
10069,False,10,11,4,0,4
10070,False,8,9,2,0,2
10071,False,7,8,7,0,7
10072,False,21,22,29,0,29
10073,False,23,24,16,0,16
10074,False,24,25,59,0,59
10075,False,4,5,2,0,2
10076,False,9,10,4,0,4
10077,False,14,15,18,2,16
10078,False,64,65,23,5,18
10079,False,18,19,10,1,9
10080,False,17,18,11,0,11
10081,False,47,48,47,0,47
10082,False,18,19,17,1,16
10083,False,16,17,29,0,29
10084,False,7,8,32,0,32
10085,False,6,7,1,0,1
10086,False,6,7,6,0,6
10087,False,23,24,43,1,42
10088,False,6,7,8,0,8
10089,False,11,12,2,0,2
10090,False,38,39,18,0,18
10091,False,14,15,57,0,57
10092,False,20,21,32,1,31
10093,False,9,10,4,0,4
10094,False,40,41,33,2,31
10095,False,7,8,2,0,2
10096,False,11,12,7,0,7
10097,False,8,9,6,0,6
10098,False,14,15,36,2,34
10099,False,20,21,7,1,6
10100,False,29,30,19,0,19
10101,False,39,40,39,2,37
10102,False,8,9,5,0,5
10103,False,22,23,34,2,32
10104,False,5,6,2,0,2
10105,False,15,16,32,0,32
10106,False,3,4,1,0,1
10107,False,14,15,7,0,7
10108,False,17,18,9,1,8
10109,False,27,28,20,0,20
10110,False,44,45,31,0,31
10111,False,11,12,41,0,41
10112,False,15,16,27,0,27
10113,False,25,26,12,0,12
10114,False,26,27,39,0,39
10115,False,28,29,10,0,10
10116,False,30,31,23,0,23
10117,False,36,37,44,1,43
10118,False,19,20,23,4,19
10119,False,17,18,81,2,79
10120,False,64,65,29,8,21
10121,False,13,14,3,1,2
10122,False,2,3,3,0,3
10123,False,59,60,51,0,51
10124,False,27,28,13,0,13
10125,False,2,3,0,0,0
10126,False,19,20,15,0,15
10127,False,10,11,3,0,3
10128,False,20,21,10,1,9
10129,False,20,21,19,0,19
10130,False,24,25,11,0,11
10131,False,37,38,36,1,35
10132,False,12,13,3,0,3
10133,False,12,13,0,0,0
10134,False,35,36,35,0,35
10135,False,44,45,63,0,63
10136,False,41,42,32,0,32
10137,False,13,14,10,0,10
10138,False,4,5,1,0,1
10139,False,6,7,2,2,0
10140,False,26,27,57,2,55
10141,False,38,39,62,1,61
10142,False,20,21,12,2,10
10143,False,11,12,29,1,28
10144,False,35,36,29,0,29
10145,False,60,61,36,0,36
10146,False,26,27,8,0,8
10147,False,14,15,15,2,13
10148,False,13,14,14,0,14
10149,False,46,47,42,0,42
10150,False,10,11,10,0,10
10151,False,18,19,43,3,40
10152,False,8,9,17,0,17
10153,False,11,12,37,7,30
10154,False,41,42,55,0,55
10155,False,8,9,9,0,9
10156,False,35,36,12,0,12
10157,False,21,22,17,0,17
10158,False,20,21,45,1,44
10159,False,11,12,28,2,26
10160,False,13,14,14,0,14
10161,False,11,12,10,0,10
10162,False,17,18,2,0,2
10163,False,16,17,11,1,10
10164,False,31,32,23,1,22
10165,False,36,37,17,1,16
10166,False,17,18,14,0,14
10167,False,2,3,3,0,3
10168,False,16,17,15,0,15
10169,False,48,49,106,0,106
10170,False,21,22,15,0,15
10171,False,10,11,7,1,6
10172,False,6,7,0,0,0
10173,False,10,11,3,0,3
10174,False,42,43,41,0,41
10175,False,3,4,3,0,3
10176,False,44,45,19,1,18
10177,False,2,3,4,0,4
10178,False,32,33,24,0,24
10179,False,7,8,8,0,8
10180,False,35,36,61,1,60
10181,False,9,10,25,0,25
10182,False,15,16,2,1,1
10183,False,24,25,24,0,24
10184,False,9,10,20,3,17
10185,False,15,16,13,0,13
10186,False,6,7,0,0,0
10187,False,10,11,4,1,3
10188,False,35,36,36,0,36
10189,False,31,32,57,0,57
10190,False,9,10,4,0,4
10191,False,13,14,10,2,8
10192,False,50,51,38,0,38
10193,False,8,9,5,0,5
10194,False,55,56,50,0,50
10195,False,15,16,5,0,5
10196,False,36,37,7,0,7
10197,False,36,37,28,0,28
10198,False,6,7,12,1,11
10199,False,12,13,6,0,6
10200,False,3,4,0,0,0
10201,False,55,56,30,1,29
10202,False,4,5,1,0,1
10203,False,7,8,5,0,5
10204,False,5,6,6,0,6
10205,False,17,18,20,1,19
10206,False,11,12,15,0,15
10207,False,33,34,22,0,22
10208,False,5,6,4,0,4
10209,False,8,9,3,0,3
10210,False,58,59,27,1,26
10211,False,22,23,9,1,8
10212,False,13,14,6,2,4
10213,False,5,6,5,1,4
10214,False,8,9,10,0,10
10215,False,14,15,32,0,32
10216,False,25,26,65,1,64
10217,False,3,4,2,0,2
10218,False,22,23,17,0,17
10219,False,25,26,14,0,14
10220,False,22,23,12,1,11
10221,False,30,31,6,0,6
10222,False,23,24,12,0,12
10223,False,17,18,8,0,8
10224,False,23,24,21,0,21
10225,False,19,20,9,0,9
10226,False,13,14,10,0,10
10227,False,8,9,6,0,6
10228,False,33,34,27,1,26
10229,False,8,9,12,0,12
10230,False,14,15,9,0,9
10231,False,22,23,8,0,8
10232,False,10,11,36,2,34
10233,False,9,10,6,1,5
10234,False,37,38,67,0,67
10235,False,17,18,8,0,8
10236,False,9,10,10,0,10
10237,False,12,13,14,0,14
10238,False,10,11,10,1,9
10239,False,16,17,31,1,30
10240,False,16,17,34,0,34
10241,False,40,41,49,0,49
10242,False,4,5,2,0,2
10243,False,30,31,54,2,52
10244,False,31,32,24,1,23
10245,False,13,14,33,2,31
10246,False,42,43,27,0,27
10247,False,11,12,35,2,33
10248,False,11,12,15,1,14
10249,False,9,10,4,0,4
10250,False,52,53,37,0,37
10251,False,1,2,0,0,0
10252,False,18,19,26,0,26
10253,False,19,20,32,1,31
10254,False,39,40,39,1,38
10255,False,21,22,18,0,18
10256,False,15,16,5,0,5
10257,False,11,12,6,0,6
10258,False,33,34,13,1,12
10259,False,20,21,38,0,38
10260,False,6,7,4,0,4
10261,False,18,19,6,0,6
10262,False,18,19,13,1,12
10263,False,15,16,22,0,22
10264,False,14,15,19,1,18
10265,False,6,7,2,0,2
10266,False,31,32,92,2,90
10267,False,13,14,20,1,19
10268,False,26,27,44,1,43
10269,False,14,15,8,0,8
10270,False,8,9,7,0,7
10271,False,24,25,14,0,14
10272,False,9,10,8,4,4
10273,False,27,28,47,1,46
10274,False,6,7,4,0,4
10275,False,23,24,33,0,33
10276,False,12,13,4,0,4
10277,False,3,4,2,0,2
10278,False,28,29,34,0,34
10279,False,30,31,15,1,14
10280,False,31,32,9,0,9
10281,False,26,27,59,0,59
10282,False,10,11,8,0,8
10283,False,10,11,3,0,3
10284,False,37,38,12,0,12
10285,False,12,13,1,0,1
10286,False,12,13,1,0,1
10287,False,12,13,3,1,2
10288,False,15,16,6,0,6
10289,False,11,12,16,0,16
10290,False,4,5,4,0,4
10291,False,30,31,14,0,14
10292,False,11,12,17,0,17
10293,False,35,36,17,1,16
10294,False,29,30,31,0,31
10295,False,29,30,11,0,11
10296,False,27,28,88,5,83
10297,False,19,20,29,0,29
10298,False,14,15,20,1,19
10299,False,15,16,4,0,4
10300,False,6,7,5,0,5
10301,False,8,9,7,0,7
10302,False,20,21,31,0,31
10303,False,19,20,10,0,10
10304,False,44,45,37,1,36
10305,False,12,13,7,0,7
10306,False,13,14,11,0,11
10307,False,24,25,14,0,14
10308,False,27,28,31,0,31
10309,False,36,37,73,1,72
10310,False,18,19,16,0,16
10311,False,23,24,41,0,41
10312,False,22,23,21,1,20
10313,False,10,11,6,0,6
10314,False,35,36,21,0,21
10315,False,28,29,8,0,8
10316,False,31,32,20,0,20
10317,False,22,23,61,0,61
10318,False,27,28,16,0,16
10319,False,30,31,51,0,51
10320,False,12,13,37,0,37
10321,False,7,8,3,0,3
10322,False,15,16,9,0,9
10323,False,6,7,3,0,3
10324,False,16,17,41,0,41
10325,False,10,11,6,0,6
10326,False,15,16,9,0,9
10327,False,15,16,8,0,8
10328,False,26,27,21,0,21
10329,False,23,24,13,0,13
10330,False,7,8,0,0,0
10331,False,48,49,0,0,0
10332,False,6,7,7,0,7
10333,False,31,32,44,1,43
10334,False,26,27,58,0,58
10335,False,13,14,3,0,3
10336,False,25,26,36,1,35
10337,False,26,27,38,0,38
10338,False,22,23,29,0,29
10339,False,20,21,11,0,11
10340,False,11,12,14,1,13
10341,False,7,8,2,0,2
10342,False,35,36,38,2,36
10343,False,18,19,8,0,8
10344,False,44,45,30,1,29
10345,False,39,40,19,0,19
10346,False,21,22,26,0,26
10347,False,22,23,25,0,25
10348,False,34,35,75,3,72
10349,False,6,7,4,1,3
10350,False,14,15,11,0,11
10351,False,20,21,21,0,21
10352,False,10,11,1,0,1
10353,False,51,52,26,0,26
10354,False,10,11,2,1,1
10355,False,14,15,4,0,4
10356,False,17,18,5,0,5
10357,False,24,25,10,1,9
10358,False,15,16,5,0,5
10359,False,67,68,39,5,34
10360,False,10,11,5,0,5
10361,False,13,14,52,2,50
10362,False,34,35,21,1,20
10363,False,8,9,2,1,1
10364,False,25,26,40,0,40
10365,False,2,3,5,0,5
10366,False,8,9,8,0,8
10367,False,16,17,10,0,10
10368,False,10,11,29,0,29
10369,False,25,26,39,0,39
10370,False,23,24,11,0,11
10371,False,9,10,14,0,14
10372,False,14,15,58,0,58
10373,False,49,50,46,0,46
10374,False,6,7,5,0,5
10375,False,16,17,6,0,6
10376,False,15,16,3,0,3
10377,False,11,12,36,1,35
10378,False,27,28,45,3,42
10379,False,44,45,13,1,12
10380,False,30,31,21,2,19
10381,False,12,13,6,0,6
10382,False,16,17,30,0,30
10383,False,11,12,1,0,1
10384,False,4,5,3,0,3
10385,False,33,34,35,3,32
10386,False,23,24,16,0,16
10387,False,13,14,6,0,6
10388,False,16,17,10,0,10
10389,False,27,28,36,0,36
10390,False,24,25,18,0,18
10391,False,18,19,6,0,6
10392,False,20,21,7,0,7
10393,False,16,17,27,0,27
10394,False,18,19,32,0,32
10395,False,8,9,0,0,0
10396,False,20,21,16,0,16
10397,False,20,21,9,0,9
10398,False,4,5,3,0,3
10399,False,15,16,6,0,6
10400,False,21,22,10,0,10
10401,False,10,11,31,0,31
10402,False,26,27,26,0,26
10403,False,26,27,15,0,15
10404,False,31,32,74,0,74
10405,False,16,17,37,5,32
10406,False,11,12,12,0,12
10407,False,9,10,12,0,12
10408,False,9,10,4,0,4
10409,False,7,8,5,0,5
10410,False,6,7,6,0,6
10411,False,7,8,13,2,11
10412,False,11,12,11,0,11
10413,False,36,37,37,0,37
10414,False,11,12,6,1,5
10415,False,12,13,31,0,31
10416,False,30,31,15,0,15
10417,False,12,13,8,0,8
10418,False,12,13,8,0,8
10419,False,40,41,82,3,79
10420,False,16,17,10,1,9
10421,False,10,11,3,0,3
10422,False,1,2,1,0,1
10423,False,20,21,30,0,30
10424,False,27,28,20,0,20
10425,False,20,21,36,0,36
10426,False,9,10,34,0,34
10427,False,15,16,31,2,29
10428,False,12,13,2,0,2
10429,False,7,8,6,0,6
10430,False,32,33,8,0,8
10431,False,29,30,16,0,16
10432,False,7,8,2,0,2
10433,False,6,7,6,0,6
10434,False,21,22,50,0,50
10435,False,15,16,28,0,28
10436,False,22,23,14,0,14
10437,False,19,20,29,0,29
10438,False,9,10,3,1,2
10439,False,8,9,4,0,4
10440,False,6,7,4,0,4
10441,False,28,29,40,2,38
10442,False,3,4,5,0,5
10443,False,23,24,17,0,17
10444,False,13,14,2,0,2
10445,False,18,19,14,0,14
10446,False,11,12,3,0,3
10447,False,5,6,3,0,3
10448,False,5,6,9,2,7
10449,False,17,18,7,0,7
10450,False,51,52,48,0,48
10451,False,34,35,18,0,18
10452,False,13,14,13,0,13
10453,False,6,7,0,0,0
10454,False,30,31,24,1,23
10455,False,12,13,6,0,6
10456,False,23,24,5,0,5
10457,False,35,36,55,0,55
10458,False,3,4,0,0,0
10459,False,26,27,15,0,15
10460,False,14,15,34,0,34
10461,False,29,30,21,0,21
10462,False,38,39,25,0,25
10463,False,25,26,17,0,17
10464,False,24,25,12,0,12
10465,False,11,12,10,0,10
10466,False,43,44,51,0,51
10467,False,4,5,1,0,1
10468,False,22,23,7,0,7
10469,False,20,21,24,2,22
10470,False,6,7,23,0,23
10471,False,33,34,62,2,60
10472,False,8,9,5,0,5
10473,False,47,48,71,0,71
10474,False,9,10,2,0,2
10475,False,25,26,4,0,4
10476,False,4,5,3,0,3
10477,False,17,18,13,0,13
10478,False,20,21,10,0,10
10479,False,28,29,60,1,59
10480,False,12,13,49,3,46
10481,False,9,10,12,0,12
10482,False,9,10,11,1,10
10483,False,11,12,12,0,12
10484,False,20,21,59,8,51
10485,False,22,23,17,3,14
10486,False,6,7,27,0,27
10487,False,11,12,34,2,32
10488,False,31,32,29,0,29
10489,False,36,37,59,0,59
10490,False,17,18,25,0,25
10491,False,7,8,5,0,5
10492,False,13,14,21,0,21
10493,False,33,34,61,1,60
10494,False,4,5,11,1,10
10495,False,6,7,0,0,0
10496,False,42,43,34,0,34
10497,False,27,28,52,1,51
10498,False,3,4,37,0,37
10499,False,27,28,22,0,22
10500,False,7,8,4,2,2
10501,False,11,12,18,0,18
10502,False,16,17,28,0,28
10503,False,11,12,2,1,1
10504,False,24,25,17,0,17
10505,False,5,6,4,0,4
10506,False,7,8,2,0,2
10507,False,18,19,13,3,10
10508,False,6,7,0,0,0
10509,False,3,4,0,0,0
10510,False,5,6,12,0,12
10511,False,31,32,64,2,62
10512,False,8,9,8,2,6
10513,False,9,10,6,3,3
10514,False,24,25,12,0,12
10515,False,21,22,11,0,11
10516,False,18,19,13,0,13
10517,False,6,7,4,0,4
10518,False,36,37,45,0,45
10519,False,40,41,18,0,18
10520,False,24,25,2,0,2
10521,False,32,33,37,0,37
10522,False,43,44,25,0,25
10523,False,7,8,8,0,8
10524,False,21,22,35,3,32
10525,False,59,60,58,0,58
10526,False,12,13,34,0,34
10527,False,15,16,25,0,25
10528,False,22,23,49,0,49
10529,False,4,5,2,0,2
10530,False,34,35,6,0,6
10531,False,8,9,4,1,3
10532,False,26,27,5,0,5
10533,False,22,23,11,0,11
10534,False,15,16,13,0,13
10535,False,9,10,8,0,8
10536,False,10,11,3,1,2
10537,False,7,8,10,0,10
10538,False,18,19,55,0,55
10539,False,7,8,9,0,9
10540,False,5,6,3,0,3
10541,False,9,10,11,0,11
10542,False,8,9,2,1,1
10543,False,17,18,2,0,2
10544,False,7,8,6,0,6
10545,False,22,23,17,0,17
10546,False,15,16,8,0,8
10547,False,7,8,5,1,4
10548,False,27,28,19,1,18
10549,False,11,12,7,1,6
10550,False,30,31,18,0,18
10551,False,22,23,42,0,42
10552,False,24,25,18,0,18
10553,False,20,21,20,0,20
10554,False,15,16,57,1,56
10555,False,5,6,5,0,5
10556,False,20,21,9,0,9
10557,False,26,27,14,0,14
10558,False,9,10,1,0,1
10559,False,25,26,13,0,13
10560,False,21,22,10,0,10
10561,False,25,26,18,1,17
10562,False,27,28,2,0,2
10563,False,6,7,8,0,8
10564,False,9,10,3,0,3
10565,False,22,23,15,1,14
10566,False,23,24,8,0,8
10567,False,19,20,23,0,23
10568,False,24,25,14,0,14
10569,False,33,34,21,0,21
10570,False,18,19,15,0,15
10571,False,10,11,4,0,4
10572,False,15,16,8,0,8
10573,False,22,23,8,0,8
10574,False,16,17,8,0,8
10575,False,7,8,4,0,4
10576,False,10,11,2,2,0
10577,False,9,10,4,0,4
10578,False,26,27,35,0,35
10579,False,38,39,15,1,14
10580,False,26,27,44,4,40
10581,False,1,2,0,0,0
10582,False,24,25,20,3,17
10583,False,26,27,52,0,52
10584,False,14,15,44,1,43
10585,False,35,36,30,1,29
10586,False,32,33,14,0,14
10587,False,6,7,6,0,6
10588,False,27,28,16,0,16
10589,False,12,13,5,0,5
10590,False,17,18,15,0,15
10591,False,10,11,7,0,7
10592,False,19,20,8,0,8
10593,False,8,9,6,0,6
10594,False,11,12,3,1,2
10595,False,6,7,3,0,3
10596,False,13,14,15,0,15
10597,False,16,17,37,11,26
10598,False,20,21,31,0,31
10599,False,20,21,14,0,14
10600,False,38,39,38,0,38
10601,False,17,18,12,0,12
10602,False,18,19,22,0,22
10603,False,39,40,32,0,32
10604,False,1,2,0,0,0
10605,False,30,31,82,0,82
10606,False,10,11,26,0,26
10607,False,25,26,10,0,10
10608,False,25,26,18,0,18
10609,False,10,11,29,2,27
10610,False,15,16,0,0,0
10611,False,41,42,13,0,13
10612,False,16,17,22,2,20
10613,False,10,11,32,1,31
10614,False,33,34,64,0,64
10615,False,12,13,1,1,0
10616,False,25,26,36,0,36
10617,False,13,14,34,0,34
10618,False,26,27,55,2,53
10619,False,16,17,20,0,20
10620,False,9,10,6,0,6
10621,False,33,34,42,0,42
10622,False,3,4,5,0,5
10623,False,14,15,6,0,6
10624,False,26,27,13,0,13
10625,False,17,18,54,0,54
10626,False,33,34,58,0,58
10627,False,10,11,24,0,24
10628,False,26,27,9,0,9
10629,False,43,44,46,0,46
10630,False,13,14,30,1,29
10631,False,6,7,5,0,5
10632,False,21,22,15,0,15
10633,False,15,16,15,1,14
10634,False,36,37,32,0,32
10635,False,18,19,70,0,70
10636,False,13,14,7,0,7
10637,False,25,26,28,0,28
10638,False,49,50,70,0,70
10639,False,22,23,6,0,6
10640,False,11,12,0,0,0
10641,False,10,11,2,0,2
10642,False,8,9,9,2,7
10643,False,39,40,22,1,21
10644,False,22,23,10,0,10
10645,False,16,17,14,0,14
10646,False,8,9,8,0,8
10647,False,8,9,14,0,14
10648,False,37,38,44,0,44
10649,False,25,26,18,0,18
10650,False,20,21,12,0,12
10651,False,3,4,0,0,0
10652,False,17,18,9,0,9
10653,False,8,9,10,0,10
10654,False,14,15,2,0,2
10655,False,5,6,4,0,4
10656,False,14,15,36,3,33
10657,False,17,18,9,0,9
10658,False,26,27,43,0,43
10659,False,9,10,1,0,1
10660,False,10,11,2,0,2
10661,False,27,28,37,0,37
10662,False,38,39,15,0,15
10663,False,38,39,32,0,32
10664,False,49,50,22,0,22
10665,False,14,15,34,0,34
10666,False,13,14,12,1,11
10667,False,38,39,70,0,70
10668,False,23,24,19,0,19
10669,False,7,8,3,0,3
10670,False,18,19,43,0,43
10671,False,8,9,2,0,2
10672,False,12,13,33,2,31
10673,False,23,24,18,0,18
10674,False,19,20,8,0,8
10675,False,13,14,6,2,4
10676,False,17,18,30,0,30
10677,False,21,22,9,0,9
10678,False,6,7,4,0,4
10679,False,26,27,38,0,38
10680,False,8,9,6,0,6
10681,False,11,12,26,0,26
10682,False,22,23,32,0,32
10683,False,35,36,50,0,50
10684,False,15,16,4,0,4
10685,False,6,7,11,0,11
10686,False,9,10,45,5,40
10687,False,18,19,9,0,9
10688,False,17,18,6,0,6
10689,False,6,7,0,0,0
10690,False,6,7,3,0,3
10691,False,9,10,4,0,4
10692,False,28,29,65,0,65
10693,False,24,25,20,0,20
10694,False,10,11,8,1,7
10695,False,7,8,5,0,5
10696,False,17,18,9,0,9
10697,False,17,18,66,0,66
10698,False,7,8,13,0,13
10699,False,9,10,11,0,11
10700,False,9,10,1,0,1
10701,False,5,6,10,0,10
10702,False,11,12,7,3,4
10703,False,9,10,0,0,0
10704,False,4,5,29,0,29
10705,False,8,9,58,1,57
10706,False,12,13,8,0,8
10707,False,19,20,18,1,17
10708,False,30,31,17,0,17
10709,False,17,18,5,2,3
10710,False,14,15,18,0,18
10711,False,7,8,3,0,3
10712,False,12,13,43,0,43
10713,False,11,12,10,0,10
10714,False,10,11,59,1,58
10715,False,19,20,3,0,3
10716,False,8,9,8,0,8
10717,False,12,13,27,1,26
10718,False,9,10,2,0,2
10719,False,26,27,46,2,44
10720,False,30,31,16,0,16
10721,False,9,10,29,0,29
10722,False,8,9,8,0,8
10723,False,2,3,3,0,3
10724,False,15,16,2,0,2
10725,False,3,4,1,0,1
10726,False,35,36,39,0,39
10727,False,17,18,8,0,8
10728,False,17,18,16,3,13
10729,False,32,33,35,0,35
10730,False,23,24,16,0,16
10731,False,8,9,25,0,25
10732,False,8,9,5,0,5
10733,False,7,8,4,0,4
10734,False,10,11,0,0,0
10735,False,3,4,4,0,4
10736,False,8,9,4,0,4
10737,False,28,29,34,0,34
10738,False,27,28,17,0,17
10739,False,14,15,15,0,15
10740,False,7,8,24,1,23
10741,False,33,34,23,1,22
10742,False,12,13,35,1,34
10743,False,5,6,36,0,36
10744,False,1,2,10,0,10
10745,False,48,49,24,0,24
10746,False,36,37,17,0,17
10747,False,14,15,10,0,10
10748,False,7,8,5,0,5
10749,False,12,13,18,0,18
10750,False,5,6,2,0,2
10751,False,10,11,8,0,8
10752,False,13,14,8,0,8
10753,False,20,21,82,0,82
10754,False,22,23,13,0,13
10755,False,22,23,61,2,59
10756,False,22,23,15,1,14
10757,False,46,47,49,0,49
10758,False,31,32,20,0,20
10759,False,26,27,43,0,43
10760,False,12,13,32,0,32
10761,False,2,3,0,0,0
10762,False,4,5,1,0,1
10763,False,9,10,3,0,3
10764,False,4,5,0,0,0
10765,False,25,26,9,0,9
10766,False,17,18,14,1,13
10767,False,17,18,5,0,5
10768,False,10,11,9,0,9
10769,False,11,12,10,0,10
10770,False,18,19,30,1,29
10771,False,25,26,37,0,37
10772,False,16,17,38,1,37
10773,False,15,16,78,2,76
10774,False,15,16,30,0,30
10775,False,17,18,14,0,14
10776,False,16,17,52,2,50
10777,False,17,18,32,4,28
10778,False,5,6,21,0,21
10779,False,17,18,7,0,7
10780,False,51,52,10,1,9
10781,False,10,11,3,1,2
10782,False,7,8,3,1,2
10783,False,18,19,13,0,13
10784,False,52,53,32,0,32
10785,False,38,39,50,0,50
10786,False,8,9,32,0,32
10787,False,31,32,7,0,7
10788,False,16,17,30,0,30
10789,False,9,10,39,0,39
10790,False,7,8,10,0,10
10791,False,24,25,21,0,21
10792,False,33,34,67,0,67
10793,False,27,28,18,0,18
10794,False,14,15,9,0,9
10795,False,8,9,4,0,4
10796,False,12,13,5,0,5
10797,False,15,16,9,1,8
10798,False,25,26,11,0,11
10799,False,6,7,6,0,6
10800,False,13,14,16,0,16
10801,False,11,12,28,0,28
10802,False,13,14,10,2,8
10803,False,11,12,14,0,14
10804,False,3,4,1,0,1
10805,False,22,23,24,0,24
10806,False,36,37,14,0,14
10807,False,38,39,28,0,28
10808,False,3,4,1,0,1
10809,False,15,16,9,0,9
10810,False,14,15,8,0,8
10811,False,15,16,6,0,6
10812,False,15,16,31,0,31
10813,False,1,2,2,0,2
10814,False,11,12,5,0,5
10815,False,12,13,6,0,6
10816,False,55,56,53,0,53
10817,False,29,30,37,0,37
10818,False,5,6,0,0,0
10819,False,43,44,41,1,40
10820,False,4,5,4,0,4
10821,False,18,19,58,0,58
10822,False,12,13,2,0,2
10823,False,28,29,18,0,18
10824,False,23,24,17,0,17
10825,False,16,17,14,0,14
10826,False,14,15,6,0,6
10827,False,31,32,30,0,30
10828,False,16,17,13,0,13
10829,False,35,36,33,3,30
10830,False,6,7,5,0,5
10831,False,6,7,5,0,5
10832,False,27,28,26,0,26
10833,False,37,38,68,0,68
10834,False,14,15,18,0,18
10835,False,4,5,8,1,7
10836,False,10,11,8,0,8
10837,False,6,7,35,0,35
10838,False,11,12,48,0,48
10839,False,33,34,38,1,37
10840,False,7,8,0,0,0
10841,False,12,13,5,0,5
10842,False,33,34,31,1,30
10843,False,8,9,28,0,28
10844,False,36,37,21,1,20
10845,False,7,8,10,0,10
10846,False,54,55,23,1,22
10847,False,20,21,9,0,9
10848,False,13,14,5,0,5
10849,False,7,8,1,0,1
10850,False,6,7,1,1,0
10851,False,14,15,43,0,43
10852,False,14,15,7,0,7
10853,False,19,20,12,0,12
10854,False,5,6,33,0,33
10855,False,10,11,2,0,2
10856,False,3,4,3,0,3
10857,False,9,10,5,0,5
10858,False,21,22,9,1,8
10859,False,7,8,1,0,1
10860,False,28,29,17,0,17
10861,False,35,36,16,0,16
10862,False,9,10,13,0,13
10863,False,8,9,9,0,9
10864,False,22,23,22,0,22
10865,False,8,9,60,3,57
10866,False,30,31,12,0,12
10867,False,37,38,12,0,12
10868,False,30,31,20,0,20
10869,False,9,10,10,1,9
10870,False,1,2,0,0,0
10871,False,16,17,11,0,11
10872,False,20,21,25,10,15
10873,False,10,11,33,1,32
10874,False,22,23,23,0,23
10875,False,2,3,4,0,4
10876,False,13,14,36,1,35
10877,False,12,13,9,0,9
10878,False,18,19,52,0,52
10879,False,10,11,8,0,8
10880,False,27,28,11,0,11
10881,False,5,6,4,0,4
10882,False,7,8,3,0,3
10883,False,13,14,13,1,12
10884,False,8,9,11,0,11
10885,False,10,11,16,0,16
10886,False,3,4,7,0,7
10887,False,22,23,21,0,21
10888,False,7,8,3,0,3
10889,False,15,16,33,0,33
10890,False,24,25,13,0,13
10891,False,8,9,2,0,2
10892,False,8,9,3,0,3
10893,False,25,26,12,1,11
10894,False,11,12,32,1,31
10895,False,8,9,2,1,1
10896,False,13,14,30,1,29
10897,False,11,12,0,0,0
10898,False,73,74,60,1,59
10899,False,12,13,10,0,10
10900,False,5,6,0,0,0
10901,False,28,29,14,0,14
10902,False,15,16,28,0,28
10903,False,9,10,11,0,11
10904,False,24,25,109,2,107
10905,False,52,53,63,0,63
10906,False,16,17,35,0,35
10907,False,16,17,6,0,6
10908,False,21,22,21,0,21
10909,False,15,16,12,0,12
10910,False,3,4,2,0,2
10911,False,25,26,10,1,9
10912,False,17,18,17,0,17
10913,False,7,8,1,0,1
10914,False,16,17,6,1,5
10915,False,2,3,1,1,0
10916,False,21,22,6,0,6
10917,False,37,38,42,1,41
10918,False,13,14,8,0,8
10919,False,19,20,10,0,10
10920,False,4,5,3,0,3
10921,False,5,6,3,0,3
10922,False,20,21,4,0,4
10923,False,6,7,4,0,4
10924,False,12,13,4,0,4
10925,False,13,14,8,0,8
10926,False,5,6,5,0,5
10927,False,32,33,60,0,60
10928,False,42,43,25,2,23
10929,False,24,25,15,0,15
10930,False,6,7,1,0,1
10931,False,12,13,9,0,9
10932,False,48,49,41,0,41
10933,False,22,23,14,0,14
10934,False,29,30,65,0,65
10935,False,5,6,2,1,1
10936,False,3,4,1,0,1
10937,False,54,55,40,2,38
10938,False,20,21,49,2,47
10939,False,12,13,32,0,32
10940,False,7,8,10,0,10
10941,False,3,4,29,3,26
10942,False,6,7,25,2,23
10943,False,11,12,8,1,7
10944,False,21,22,23,0,23
10945,False,8,9,31,1,30
10946,False,14,15,36,2,34
10947,False,7,8,8,0,8
10948,False,14,15,44,0,44
10949,False,18,19,14,1,13
10950,False,23,24,41,0,41
10951,False,5,6,29,0,29
10952,False,57,58,52,0,52
10953,False,8,9,32,0,32
10954,False,6,7,9,0,9
10955,False,8,9,9,0,9
10956,False,19,20,11,0,11
10957,False,10,11,25,0,25
10958,False,20,21,18,1,17
10959,False,22,23,32,0,32
10960,False,2,3,0,0,0
10961,False,4,5,5,0,5
10962,False,6,7,2,0,2
10963,False,29,30,19,0,19
10964,False,9,10,14,0,14
10965,False,25,26,22,3,19
10966,False,6,7,2,0,2
10967,False,11,12,5,0,5
10968,False,7,8,3,0,3
10969,False,27,28,16,1,15
10970,False,19,20,29,1,28
10971,False,16,17,36,0,36
10972,False,15,16,6,1,5
10973,False,28,29,17,0,17
10974,False,6,7,7,0,7
10975,False,10,11,3,0,3
10976,False,10,11,6,0,6
10977,False,3,4,0,0,0
10978,False,27,28,19,0,19
10979,False,12,13,34,2,32
10980,False,8,9,5,0,5
10981,False,17,18,7,0,7
10982,False,21,22,35,0,35
10983,False,23,24,16,0,16
10984,False,36,37,80,1,79
10985,False,21,22,14,0,14
10986,False,11,12,3,0,3
10987,False,13,14,5,3,2
10988,False,9,10,3,0,3
10989,False,17,18,1,0,1
10990,False,22,23,14,0,14
10991,False,27,28,15,0,15
10992,False,11,12,24,1,23
10993,False,6,7,2,0,2
10994,False,15,16,4,0,4
10995,False,27,28,12,0,12
10996,False,12,13,4,0,4
10997,False,36,37,86,2,84
10998,False,14,15,7,0,7
10999,False,8,9,5,0,5
11000,False,12,13,4,0,4
11001,False,15,16,5,1,4
11002,False,6,7,24,0,24
11003,False,15,16,27,0,27
11004,False,9,10,49,1,48
11005,False,15,16,34,0,34
11006,False,22,23,7,0,7
11007,False,14,15,8,0,8
11008,False,23,24,6,0,6
11009,False,25,26,35,0,35
11010,False,9,10,2,0,2
11011,False,9,10,40,1,39
11012,False,15,16,40,0,40
11013,False,13,14,84,0,84
11014,False,7,8,0,0,0
11015,False,37,38,36,0,36
11016,False,19,20,12,0,12
11017,False,8,9,5,0,5
11018,False,14,15,8,0,8
11019,False,6,7,8,0,8
11020,False,4,5,1,0,1
11021,False,11,12,52,0,52
11022,False,21,22,13,0,13
11023,False,12,13,32,0,32
11024,False,23,24,98,0,98
11025,False,12,13,8,1,7
11026,False,10,11,9,0,9
11027,False,4,5,2,0,2
11028,False,23,24,8,0,8
11029,False,11,12,8,0,8
11030,False,12,13,12,1,11
11031,False,15,16,4,0,4
11032,False,61,62,34,1,33
11033,False,25,26,20,1,19
11034,False,14,15,42,0,42
11035,False,13,14,7,0,7
11036,False,36,37,47,0,47
11037,False,23,24,16,0,16
11038,False,7,8,13,0,13
11039,False,13,14,3,0,3
11040,False,15,16,6,0,6
11041,False,27,28,9,0,9
11042,False,30,31,13,1,12
11043,False,35,36,17,0,17
11044,False,5,6,1,0,1
11045,False,12,13,7,0,7
11046,False,9,10,14,0,14
11047,False,7,8,2,0,2
11048,False,8,9,4,0,4
11049,False,20,21,33,0,33
11050,False,10,11,30,0,30
11051,False,36,37,44,2,42
11052,False,24,25,17,0,17
11053,False,26,27,21,0,21
11054,False,9,10,35,0,35
11055,False,23,24,7,1,6
11056,False,22,23,2,0,2
11057,False,12,13,7,0,7
11058,False,10,11,5,2,3
11059,False,9,10,1,0,1
11060,False,9,10,9,0,9
11061,False,6,7,39,0,39
11062,False,13,14,9,0,9
11063,False,8,9,4,0,4
11064,False,11,12,11,0,11
11065,False,17,18,12,0,12
11066,False,9,10,0,0,0
11067,False,39,40,43,0,43
11068,False,23,24,65,0,65
11069,False,14,15,37,0,37
11070,False,45,46,34,0,34
11071,False,11,12,3,0,3
11072,False,4,5,6,0,6
11073,False,22,23,5,0,5
11074,False,29,30,41,0,41
11075,False,31,32,27,0,27
11076,False,20,21,28,0,28
11077,False,7,8,2,0,2
11078,False,14,15,46,0,46
11079,False,12,13,10,0,10
11080,False,29,30,59,1,58
11081,False,33,34,25,1,24
11082,False,41,42,27,0,27
11083,False,58,59,62,0,62
11084,False,9,10,2,1,1
11085,False,13,14,35,1,34
11086,False,11,12,19,0,19
11087,False,8,9,4,0,4
11088,False,5,6,3,0,3
11089,False,7,8,44,1,43
11090,False,38,39,17,0,17
11091,False,37,38,14,0,14
11092,False,22,23,60,2,58
11093,False,12,13,38,1,37
11094,False,7,8,10,0,10
11095,False,7,8,4,0,4
11096,False,23,24,14,0,14
11097,False,25,26,12,0,12
11098,False,14,15,26,2,24
11099,False,22,23,8,0,8
11100,False,23,24,12,0,12
11101,False,10,11,3,0,3
11102,False,4,5,1,0,1
11103,False,10,11,8,0,8
11104,False,33,34,18,0,18
11105,False,26,27,15,0,15
11106,False,18,19,2,0,2
11107,False,12,13,9,0,9
11108,False,10,11,5,0,5
11109,False,26,27,10,1,9
11110,False,19,20,6,0,6
11111,False,8,9,8,0,8
11112,False,5,6,1,0,1
11113,False,10,11,7,1,6
11114,False,39,40,42,0,42
11115,False,18,19,55,0,55
11116,False,21,22,14,0,14
11117,False,11,12,7,0,7
11118,False,21,22,12,0,12
11119,False,15,16,18,1,17
11120,False,27,28,30,0,30
11121,False,35,36,26,1,25
11122,False,7,8,19,2,17
11123,False,23,24,28,0,28
11124,False,47,48,32,1,31
11125,False,9,10,3,1,2
11126,False,10,11,82,3,79
11127,False,3,4,2,0,2
11128,False,17,18,0,0,0
11129,False,11,12,60,0,60
11130,False,12,13,10,0,10
11131,False,21,22,14,0,14
11132,False,20,21,36,1,35
11133,False,8,9,1,0,1
11134,False,23,24,9,0,9
11135,False,38,39,60,0,60
11136,False,32,33,35,0,35
11137,False,6,7,48,14,34
11138,False,8,9,3,0,3
11139,False,19,20,15,1,14
11140,False,21,22,5,0,5
11141,False,26,27,15,0,15
11142,False,14,15,11,2,9
11143,False,39,40,31,3,28
11144,False,40,41,15,0,15
11145,False,11,12,9,0,9
11146,False,11,12,11,0,11
11147,False,29,30,21,0,21
11148,False,62,63,39,0,39
11149,False,6,7,0,0,0
11150,False,14,15,30,2,28
11151,False,16,17,21,1,20
11152,False,26,27,16,0,16
11153,False,3,4,3,0,3
11154,False,10,11,11,0,11
11155,False,9,10,24,0,24
11156,False,18,19,14,0,14
11157,False,7,8,25,11,14
11158,False,18,19,10,0,10
11159,False,33,34,26,0,26
11160,False,5,6,30,0,30
11161,False,20,21,50,0,50
11162,False,28,29,25,0,25
11163,False,13,14,1,0,1
11164,False,12,13,6,0,6
11165,False,36,37,14,2,12
11166,False,25,26,21,0,21
11167,False,24,25,33,1,32
11168,False,18,19,17,0,17
11169,False,8,9,2,0,2
11170,False,10,11,3,0,3
11171,False,24,25,105,3,102
11172,False,35,36,75,1,74
11173,False,23,24,46,0,46
11174,False,26,27,8,0,8
11175,False,26,27,9,0,9
11176,False,7,8,2,0,2
11177,False,6,7,2,0,2
11178,False,20,21,49,0,49
11179,False,19,20,12,0,12
11180,False,7,8,6,0,6
11181,False,7,8,30,0,30
11182,False,17,18,49,0,49
11183,False,17,18,7,0,7
11184,False,23,24,15,0,15
11185,False,28,29,36,3,33
11186,False,17,18,34,2,32
11187,False,14,15,7,0,7
11188,False,35,36,54,0,54
11189,False,22,23,11,0,11
11190,False,29,30,22,1,21
11191,False,8,9,12,0,12
11192,False,7,8,0,0,0
11193,False,22,23,15,2,13
11194,False,29,30,32,1,31
11195,False,6,7,4,0,4
11196,False,21,22,18,0,18
11197,False,23,24,30,0,30
11198,False,9,10,9,1,8
11199,False,19,20,1,0,1
11200,False,26,27,13,2,11
11201,False,16,17,17,0,17
11202,False,30,31,17,0,17
11203,False,31,32,20,0,20
11204,False,13,14,8,0,8
11205,False,17,18,34,1,33
11206,False,8,9,1,0,1
11207,False,13,14,5,0,5
11208,False,11,12,5,2,3
11209,False,24,25,40,0,40
11210,False,1,2,1,0,1
11211,False,20,21,15,0,15
11212,False,18,19,12,0,12
11213,False,9,10,5,1,4
11214,False,12,13,5,1,4
11215,False,14,15,3,1,2
11216,False,18,19,9,0,9
11217,False,8,9,35,0,35
11218,False,25,26,42,0,42
11219,False,16,17,9,0,9
11220,False,24,25,11,1,10
11221,False,27,28,33,0,33
11222,False,18,19,16,0,16
11223,False,21,22,27,0,27
11224,False,3,4,1,0,1
11225,False,15,16,20,0,20
11226,False,20,21,48,10,38
11227,False,6,7,3,1,2
11228,False,24,25,46,0,46
11229,False,23,24,7,1,6
11230,False,11,12,7,0,7
11231,False,12,13,9,0,9
11232,False,2,3,4,0,4
11233,False,21,22,29,0,29
11234,False,4,5,3,0,3
11235,False,20,21,8,0,8
11236,False,5,6,0,0,0
11237,False,13,14,6,1,5
11238,False,41,42,36,0,36
11239,False,5,6,3,0,3
11240,False,16,17,5,2,3
11241,False,1,2,3,0,3
11242,False,37,38,34,0,34
11243,False,13,14,8,0,8
11244,False,11,12,10,0,10
11245,False,19,20,14,1,13
11246,False,10,11,6,0,6
11247,False,28,29,47,0,47
11248,False,21,22,34,0,34
11249,False,13,14,29,13,16
11250,False,11,12,2,1,1
11251,False,11,12,3,2,1
11252,False,40,41,22,0,22
11253,False,34,35,21,1,20
11254,False,11,12,33,0,33
11255,False,10,11,3,0,3
11256,False,6,7,7,0,7
11257,False,17,18,24,0,24
11258,False,4,5,4,0,4
11259,False,12,13,12,0,12
11260,False,12,13,32,10,22
11261,False,25,26,35,6,29
11262,False,24,25,6,0,6
11263,False,34,35,15,0,15
11264,False,20,21,46,1,45
11265,False,7,8,5,2,3
11266,False,10,11,8,0,8
11267,False,4,5,1,0,1
11268,False,22,23,19,0,19
11269,False,9,10,3,0,3
11270,False,21,22,10,0,10
11271,False,16,17,17,0,17
11272,False,10,11,27,1,26
11273,False,27,28,15,0,15
11274,False,14,15,10,0,10
11275,False,10,11,26,15,11
11276,False,9,10,10,0,10
11277,False,13,14,22,0,22
11278,False,20,21,22,3,19
11279,False,13,14,0,0,0
11280,False,6,7,0,0,0
11281,False,16,17,13,0,13
11282,False,19,20,57,0,57
11283,False,22,23,14,1,13
11284,False,31,32,18,0,18
11285,False,12,13,8,0,8
11286,False,6,7,3,1,2
11287,False,8,9,7,0,7
11288,False,11,12,37,0,37
11289,False,2,3,0,0,0
11290,False,12,13,14,0,14
11291,False,7,8,5,2,3
11292,False,15,16,8,0,8
11293,False,6,7,3,0,3
11294,False,12,13,13,0,13
11295,False,5,6,39,0,39
11296,False,26,27,64,0,64
11297,False,4,5,28,0,28
11298,False,18,19,8,0,8
11299,False,30,31,38,0,38
11300,False,23,24,14,0,14
11301,False,13,14,1,0,1
11302,False,18,19,14,1,13
11303,False,7,8,8,0,8
11304,False,6,7,4,0,4
11305,False,5,6,10,0,10
11306,False,23,24,33,9,24
11307,False,26,27,22,0,22
11308,False,7,8,3,0,3
11309,False,22,23,14,0,14
11310,False,12,13,12,1,11
11311,False,18,19,1,0,1
11312,False,22,23,8,0,8
11313,False,8,9,3,1,2
11314,False,12,13,22,0,22
11315,False,17,18,39,1,38
11316,False,31,32,22,0,22
11317,False,16,17,14,1,13
11318,False,16,17,16,0,16
11319,False,5,6,5,0,5
11320,False,12,13,12,0,12
11321,False,17,18,10,0,10
11322,False,21,22,53,2,51
11323,False,7,8,5,0,5
11324,False,35,36,26,1,25
11325,False,14,15,5,0,5
11326,False,28,29,44,1,43
11327,False,10,11,6,1,5
11328,False,1,2,0,0,0
11329,False,32,33,24,0,24
11330,False,11,12,8,1,7
11331,False,15,16,10,0,10
11332,False,9,10,7,3,4
11333,False,38,39,49,1,48
11334,False,31,32,64,0,64
11335,False,5,6,4,0,4
11336,False,14,15,31,0,31
11337,False,11,12,4,1,3
11338,False,33,34,13,0,13
11339,False,12,13,6,0,6
11340,False,30,31,15,0,15
11341,False,6,7,6,0,6
11342,False,10,11,2,0,2
11343,False,17,18,41,0,41
11344,False,19,20,13,0,13
11345,False,17,18,12,0,12
11346,False,15,16,26,0,26
11347,False,3,4,0,0,0
11348,False,2,3,0,0,0
11349,False,17,18,8,0,8
11350,False,8,9,4,1,3
11351,False,18,19,10,0,10
11352,False,30,31,8,1,7
11353,False,7,8,2,0,2
11354,False,26,27,37,0,37
11355,False,28,29,62,1,61
11356,False,11,12,3,2,1
11357,False,9,10,0,0,0
11358,False,12,13,33,0,33
11359,False,13,14,7,0,7
11360,False,5,6,4,0,4
11361,False,4,5,1,0,1
11362,False,4,5,3,0,3
11363,False,11,12,0,0,0
11364,False,14,15,6,0,6
11365,False,4,5,1,0,1
11366,False,8,9,12,0,12
11367,False,13,14,3,0,3
11368,False,6,7,2,0,2
11369,False,4,5,4,0,4
11370,False,27,28,43,0,43
11371,False,8,9,9,0,9
11372,False,4,5,4,0,4
11373,False,18,19,10,0,10
11374,False,11,12,9,0,9
11375,False,3,4,7,0,7
11376,False,28,29,21,0,21
11377,False,18,19,19,2,17
11378,False,8,9,4,0,4
11379,False,4,5,5,0,5
11380,False,4,5,3,0,3
11381,False,8,9,9,0,9
11382,False,12,13,8,0,8
11383,False,8,9,6,1,5
11384,False,12,13,5,0,5
11385,False,4,5,0,0,0
11386,False,7,8,9,0,9
11387,False,31,32,22,0,22
11388,False,17,18,53,0,53
11389,False,9,10,5,0,5
11390,False,19,20,24,0,24
11391,False,26,27,18,0,18
11392,False,10,11,4,0,4
11393,False,4,5,2,0,2
11394,False,4,5,4,0,4
11395,False,6,7,3,0,3
11396,False,11,12,10,0,10
11397,False,10,11,8,0,8
11398,False,11,12,18,0,18
11399,False,16,17,43,0,43
11400,False,24,25,19,0,19
11401,False,27,28,15,1,14
11402,False,15,16,16,0,16
11403,False,20,21,21,0,21
11404,False,39,40,78,1,77
11405,False,28,29,51,1,50
11406,False,11,12,0,0,0
11407,False,23,24,65,0,65
11408,False,40,41,17,0,17
11409,False,29,30,31,0,31
11410,False,15,16,45,0,45
11411,False,7,8,11,1,10
11412,False,20,21,64,0,64
11413,False,8,9,4,0,4
11414,False,11,12,8,0,8
11415,False,4,5,2,0,2
11416,False,10,11,8,0,8
11417,False,26,27,13,1,12
11418,False,18,19,13,0,13
11419,False,25,26,4,0,4
11420,False,37,38,59,0,59
11421,False,13,14,30,0,30
11422,False,5,6,9,0,9
11423,False,14,15,28,0,28
11424,False,22,23,4,0,4
11425,False,13,14,5,0,5
11426,False,22,23,33,0,33
11427,False,15,16,7,1,6
11428,False,27,28,9,1,8
11429,False,19,20,28,0,28
11430,False,14,15,61,1,60
11431,False,13,14,8,1,7
11432,False,18,19,44,0,44
11433,False,18,19,77,1,76
11434,False,10,11,8,0,8
11435,False,12,13,79,12,67
11436,False,17,18,10,0,10
11437,False,7,8,30,1,29
11438,False,12,13,2,0,2
11439,False,3,4,4,0,4
11440,False,13,14,7,0,7
11441,False,8,9,28,0,28
11442,False,7,8,8,0,8
11443,False,10,11,3,0,3
11444,False,8,9,27,1,26
11445,False,15,16,10,0,10
11446,False,20,21,4,0,4
11447,False,10,11,26,0,26
11448,False,27,28,34,1,33
11449,False,10,11,1,0,1
11450,False,20,21,9,0,9
11451,False,8,9,4,0,4
11452,False,3,4,8,0,8
11453,False,13,14,8,0,8
11454,False,29,30,37,0,37
11455,False,11,12,1,0,1
11456,False,11,12,9,1,8
11457,False,43,44,23,0,23
11458,False,8,9,8,0,8
11459,False,20,21,31,1,30
11460,False,12,13,10,0,10
11461,False,13,14,9,0,9
11462,False,21,22,21,2,19
11463,False,8,9,7,0,7
11464,False,5,6,23,2,21
11465,False,15,16,4,0,4
11466,False,7,8,2,0,2
11467,False,18,19,6,3,3
11468,False,26,27,10,0,10
11469,False,17,18,13,0,13
11470,False,14,15,58,2,56
11471,False,9,10,11,0,11
11472,False,11,12,27,0,27
11473,False,9,10,3,0,3
11474,False,5,6,34,0,34
11475,False,2,3,9,0,9
11476,False,9,10,26,0,26
11477,False,17,18,1,0,1
11478,False,4,5,3,0,3
11479,False,14,15,5,0,5
11480,False,11,12,44,0,44
11481,False,7,8,9,0,9
11482,False,11,12,29,5,24
11483,False,14,15,2,1,1
11484,False,19,20,14,0,14
11485,False,13,14,4,0,4
11486,False,12,13,0,0,0
11487,False,26,27,15,0,15
11488,False,7,8,9,0,9
11489,False,3,4,10,0,10
11490,False,11,12,24,8,16
11491,False,14,15,4,0,4
11492,False,9,10,2,0,2
11493,False,24,25,2,0,2
11494,False,5,6,5,0,5
11495,False,10,11,1,0,1
11496,False,20,21,17,0,17
11497,False,1,2,0,0,0
11498,False,7,8,4,0,4
11499,False,10,11,5,0,5
11500,False,25,26,21,2,19
11501,False,23,24,85,0,85
11502,False,7,8,21,0,21
11503,False,13,14,2,0,2
11504,False,8,9,7,1,6
11505,False,16,17,9,0,9
11506,False,11,12,10,0,10
11507,False,30,31,34,2,32
11508,False,20,21,34,3,31
11509,False,13,14,100,13,87
11510,False,8,9,3,2,1
11511,False,3,4,8,0,8
11512,False,6,7,55,16,39
11513,False,5,6,2,0,2
11514,False,12,13,5,1,4
11515,False,6,7,11,0,11
11516,False,28,29,6,0,6
11517,False,12,13,86,0,86
11518,False,18,19,52,0,52
11519,False,12,13,6,0,6
11520,False,14,15,10,0,10
11521,False,9,10,25,0,25
11522,False,10,11,6,0,6
11523,False,30,31,30,0,30
11524,False,19,20,7,0,7
11525,False,28,29,36,0,36
11526,False,22,23,4,1,3
11527,False,42,43,19,0,19
11528,False,32,33,15,0,15
11529,False,2,3,1,0,1
11530,False,13,14,9,0,9
11531,False,11,12,30,3,27
11532,False,42,43,27,0,27
11533,False,7,8,6,0,6
11534,False,1,2,0,0,0
11535,False,15,16,10,2,8
11536,False,8,9,5,0,5
11537,False,23,24,28,0,28
11538,False,7,8,51,0,51
11539,False,18,19,10,0,10
11540,False,17,18,2,0,2
11541,False,11,12,1,0,1
11542,False,5,6,29,0,29
11543,False,20,21,9,0,9
11544,False,8,9,25,0,25
11545,False,10,11,5,0,5
11546,False,33,34,11,0,11
11547,False,9,10,32,1,31
11548,False,16,17,6,0,6
11549,False,24,25,28,1,27
11550,False,20,21,16,1,15
11551,False,6,7,4,1,3
11552,False,9,10,7,0,7
11553,False,9,10,5,0,5
11554,False,24,25,68,0,68
11555,False,13,14,52,0,52
11556,False,31,32,37,0,37
11557,False,23,24,32,0,32
11558,False,49,50,21,0,21
11559,False,4,5,2,0,2
11560,False,8,9,8,0,8
11561,False,14,15,27,1,26
11562,False,20,21,15,0,15
11563,False,16,17,14,0,14
11564,False,3,4,1,0,1
11565,False,5,6,60,0,60
11566,False,2,3,3,0,3
11567,False,11,12,3,0,3
11568,False,13,14,5,0,5
11569,False,3,4,3,0,3
11570,False,20,21,12,0,12
11571,False,17,18,15,0,15
11572,False,19,20,9,1,8
11573,False,20,21,105,5,100
11574,False,15,16,3,1,2
11575,False,4,5,4,0,4
11576,False,4,5,2,0,2
11577,False,37,38,19,0,19
11578,False,12,13,7,1,6
11579,False,7,8,10,0,10
11580,False,18,19,20,0,20
11581,False,4,5,1,0,1
11582,False,7,8,13,0,13
11583,False,25,26,41,0,41
11584,False,11,12,2,0,2
11585,False,1,2,0,0,0
11586,False,9,10,5,0,5
11587,False,19,20,13,1,12
11588,False,15,16,6,0,6
11589,False,19,20,25,0,25
11590,False,11,12,58,4,54
11591,False,33,34,36,0,36
11592,False,26,27,58,0,58
11593,False,6,7,2,0,2
11594,False,6,7,9,0,9
11595,False,36,37,40,0,40
11596,False,11,12,6,0,6
11597,False,10,11,4,0,4
11598,False,41,42,90,0,90
11599,False,13,14,5,2,3
11600,False,22,23,19,1,18
11601,False,12,13,56,0,56
11602,False,11,12,11,0,11
11603,False,22,23,38,0,38
11604,False,12,13,6,0,6
11605,False,13,14,9,0,9
11606,False,6,7,29,0,29
11607,False,11,12,15,0,15
11608,False,9,10,13,0,13
11609,False,5,6,4,0,4
11610,False,14,15,6,0,6
11611,False,10,11,29,1,28
11612,False,8,9,39,0,39
11613,False,1,2,2,0,2
11614,False,21,22,36,0,36
11615,False,9,10,7,2,5
11616,False,36,37,23,0,23
11617,False,11,12,7,0,7
11618,False,13,14,9,0,9
11619,False,5,6,6,0,6
11620,False,7,8,2,0,2
11621,False,20,21,12,1,11
11622,False,16,17,15,0,15
11623,False,23,24,55,0,55
11624,False,32,33,22,1,21
11625,False,16,17,5,0,5
11626,False,7,8,3,0,3
11627,False,2,3,1,0,1
11628,False,24,25,35,0,35
11629,False,12,13,28,0,28
11630,False,7,8,4,0,4
11631,False,12,13,10,0,10
11632,False,15,16,6,0,6
11633,False,11,12,14,1,13
11634,False,15,16,11,0,11
11635,False,26,27,6,1,5
11636,False,8,9,2,0,2
11637,False,20,21,12,0,12
11638,False,9,10,2,0,2
11639,False,6,7,5,0,5
11640,False,19,20,15,0,15
11641,False,10,11,1,0,1
11642,False,5,6,9,0,9
11643,False,22,23,16,0,16
11644,False,16,17,13,0,13
11645,False,15,16,2,1,1
11646,False,42,43,15,1,14
11647,False,18,19,37,0,37
11648,False,18,19,36,0,36
11649,False,56,57,44,0,44
11650,False,1,2,7,0,7
11651,False,11,12,6,0,6
11652,False,10,11,4,0,4
11653,False,12,13,5,0,5
11654,False,10,11,8,0,8
11655,False,6,7,4,0,4
11656,False,13,14,3,1,2
11657,False,10,11,40,3,37
11658,False,2,3,2,0,2
11659,False,8,9,10,0,10
11660,False,16,17,49,0,49
11661,False,32,33,35,0,35
11662,False,7,8,5,0,5
11663,False,1,2,0,0,0
11664,False,27,28,13,1,12
11665,False,7,8,10,0,10
11666,False,29,30,56,1,55
11667,False,22,23,11,2,9
11668,False,15,16,69,1,68
11669,False,7,8,9,0,9
11670,False,11,12,12,0,12
11671,False,15,16,17,0,17
11672,False,28,29,27,0,27
11673,False,11,12,13,0,13
11674,False,18,19,4,0,4
11675,False,18,19,11,1,10
11676,False,1,2,6,0,6
11677,False,26,27,38,1,37
11678,False,21,22,32,0,32
11679,False,8,9,10,0,10
11680,False,10,11,6,1,5
11681,False,16,17,38,0,38
11682,False,37,38,45,0,45
11683,False,11,12,3,0,3
11684,False,26,27,13,0,13
11685,False,14,15,7,0,7
11686,False,18,19,14,0,14
11687,False,11,12,3,0,3
11688,False,8,9,7,0,7
11689,False,6,7,2,0,2
11690,False,13,14,53,4,49
11691,False,8,9,24,0,24
11692,False,6,7,32,0,32
11693,False,5,6,3,0,3
11694,False,28,29,25,0,25
11695,False,13,14,48,3,45
11696,False,7,8,3,0,3
11697,False,17,18,2,0,2
11698,False,9,10,11,0,11
11699,False,27,28,9,0,9
11700,False,11,12,4,2,2
11701,False,11,12,13,1,12
11702,False,37,38,42,0,42
11703,False,26,27,20,0,20
11704,False,33,34,23,0,23
11705,False,10,11,35,0,35
11706,False,15,16,7,0,7
11707,False,17,18,15,0,15
11708,False,4,5,1,0,1
11709,False,10,11,3,0,3
11710,False,15,16,2,0,2
11711,False,35,36,28,0,28
11712,False,14,15,17,1,16
11713,False,19,20,24,0,24
11714,False,10,11,8,0,8
11715,False,53,54,24,0,24
11716,False,4,5,3,0,3
11717,False,27,28,20,0,20
11718,False,11,12,1,0,1
11719,False,5,6,4,0,4
11720,False,13,14,8,0,8
11721,False,12,13,3,1,2
11722,False,24,25,11,1,10
11723,False,16,17,28,0,28
11724,False,13,14,53,1,52
11725,False,3,4,0,0,0
11726,False,5,6,7,0,7
11727,False,19,20,22,0,22
11728,False,26,27,41,0,41
11729,False,16,17,27,0,27
11730,False,3,4,4,0,4
11731,False,11,12,7,0,7
11732,False,13,14,9,1,8
11733,False,4,5,2,0,2
11734,False,12,13,4,0,4
11735,False,18,19,9,0,9
11736,False,9,10,30,0,30
11737,False,4,5,4,0,4
11738,False,16,17,33,0,33
11739,False,16,17,14,0,14
11740,False,6,7,3,0,3
11741,False,6,7,27,9,18
11742,False,8,9,8,1,7
11743,False,11,12,10,1,9
11744,False,11,12,30,0,30
11745,False,18,19,15,1,14
11746,False,12,13,25,0,25
11747,False,17,18,33,3,30
11748,False,11,12,2,0,2
11749,False,13,14,8,0,8
11750,False,12,13,2,0,2
11751,False,10,11,3,1,2
11752,False,8,9,21,1,20
11753,False,12,13,9,0,9
11754,False,23,24,13,0,13
11755,False,9,10,0,0,0
11756,False,24,25,76,0,76
11757,False,11,12,8,0,8
11758,False,12,13,3,0,3
11759,False,14,15,9,1,8
11760,False,21,22,15,0,15
11761,False,45,46,21,1,20
11762,False,18,19,5,0,5
11763,False,11,12,60,0,60
11764,False,4,5,1,0,1
11765,False,5,6,29,1,28
11766,False,24,25,11,0,11
11767,False,10,11,31,0,31
11768,False,15,16,25,1,24
11769,False,14,15,6,1,5
11770,False,15,16,3,0,3
11771,False,15,16,28,0,28
11772,False,2,3,0,0,0
11773,False,18,19,7,0,7
11774,False,6,7,6,0,6
11775,False,7,8,29,0,29
11776,False,9,10,8,2,6
11777,False,6,7,0,0,0
11778,False,9,10,6,4,2
11779,False,12,13,8,0,8
11780,False,11,12,9,0,9
11781,False,7,8,8,1,7
11782,False,22,23,38,1,37
11783,False,1,2,0,0,0
11784,False,18,19,6,0,6
11785,False,8,9,5,0,5
11786,False,19,20,21,0,21
11787,False,9,10,26,4,22
11788,False,10,11,4,1,3
11789,False,7,8,3,0,3
11790,False,10,11,5,0,5
11791,False,11,12,22,0,22
11792,False,4,5,1,0,1
11793,False,6,7,25,0,25
11794,False,11,12,34,2,32
11795,False,5,6,48,0,48
11796,False,9,10,3,0,3
11797,False,4,5,1,0,1
11798,False,15,16,15,2,13
11799,False,10,11,4,1,3
11800,False,16,17,5,0,5
11801,False,14,15,11,0,11
11802,False,16,17,0,0,0
11803,False,11,12,28,0,28
11804,False,2,3,0,0,0
11805,False,16,17,22,0,22
11806,False,12,13,19,2,17
11807,False,13,14,11,0,11
11808,False,24,25,25,1,24
11809,False,7,8,1,0,1
11810,False,12,13,2,0,2
11811,False,24,25,11,1,10
11812,False,20,21,76,1,75
11813,False,11,12,4,0,4
11814,False,3,4,29,7,22
11815,False,12,13,9,1,8
11816,False,7,8,4,0,4
11817,False,5,6,13,0,13
11818,False,13,14,27,0,27
11819,False,21,22,39,0,39
11820,False,3,4,1,0,1
11821,False,46,47,25,1,24
11822,False,16,17,12,0,12
11823,False,11,12,9,0,9
11824,False,25,26,34,0,34
11825,False,14,15,6,0,6
11826,False,21,22,20,0,20
11827,False,33,34,27,0,27
11828,False,5,6,26,2,24
11829,False,5,6,4,0,4
11830,False,9,10,4,0,4
11831,False,1,2,5,0,5
11832,False,27,28,31,0,31
11833,False,8,9,2,0,2
11834,False,8,9,1,0,1
11835,False,29,30,53,1,52
11836,False,23,24,10,0,10
11837,False,9,10,57,0,57
11838,False,2,3,1,0,1
11839,False,6,7,2,0,2
11840,False,27,28,12,0,12
11841,False,8,9,3,0,3
11842,False,21,22,12,0,12
11843,False,20,21,30,0,30
11844,False,20,21,32,2,30
11845,False,11,12,1,0,1
11846,False,32,33,11,0,11
11847,False,6,7,2,0,2
11848,False,2,3,0,0,0
11849,False,13,14,15,0,15
11850,False,7,8,2,0,2
11851,False,15,16,35,1,34
11852,False,8,9,9,0,9
11853,False,11,12,12,0,12
11854,False,9,10,10,0,10
11855,False,12,13,3,0,3
11856,False,20,21,16,0,16
11857,False,32,33,48,0,48
11858,False,13,14,5,0,5
11859,False,9,10,29,1,28
11860,False,31,32,19,0,19
11861,False,7,8,7,0,7
11862,False,10,11,3,0,3
11863,False,11,12,12,0,12
11864,False,1,2,0,0,0
11865,False,32,33,43,0,43
11866,False,23,24,41,1,40
11867,False,20,21,11,0,11
11868,False,4,5,0,0,0
11869,False,10,11,3,0,3
11870,False,2,3,0,0,0
11871,False,5,6,3,0,3
11872,False,9,10,2,0,2
11873,False,13,14,7,0,7
11874,False,6,7,46,1,45
11875,False,19,20,13,0,13
11876,False,27,28,40,5,35
11877,False,47,48,34,0,34
11878,False,18,19,10,0,10
11879,False,6,7,7,0,7
11880,False,20,21,65,0,65
11881,False,20,21,44,0,44
11882,False,6,7,3,0,3
11883,False,3,4,3,0,3
11884,False,14,15,18,0,18
11885,False,3,4,2,0,2
11886,False,5,6,5,0,5
11887,False,10,11,30,0,30
11888,False,9,10,7,0,7
11889,False,8,9,12,0,12
11890,False,8,9,8,0,8
11891,False,2,3,1,0,1
11892,False,19,20,6,0,6
11893,False,10,11,16,0,16
11894,False,16,17,8,0,8
11895,False,12,13,5,0,5
11896,False,4,5,1,0,1
11897,False,5,6,4,0,4
11898,False,7,8,6,0,6
11899,False,15,16,9,1,8
11900,False,4,5,2,0,2
11901,False,12,13,11,1,10
11902,False,20,21,8,0,8
11903,False,11,12,3,0,3
11904,False,9,10,8,0,8
11905,False,31,32,50,0,50
11906,False,4,5,1,0,1
11907,False,13,14,9,0,9
11908,False,17,18,8,0,8
11909,False,17,18,21,0,21
11910,False,7,8,8,1,7
11911,False,12,13,4,0,4
11912,False,10,11,2,0,2
11913,False,34,35,112,0,112
11914,False,5,6,1,0,1
11915,False,3,4,2,0,2
11916,False,14,15,7,0,7
11917,False,15,16,8,0,8
11918,False,10,11,10,0,10
11919,False,14,15,20,0,20
11920,False,7,8,0,0,0
11921,False,14,15,2,1,1
11922,False,6,7,4,0,4
11923,False,21,22,20,1,19
11924,False,5,6,4,2,2
11925,False,9,10,8,0,8
11926,False,12,13,4,0,4
11927,False,2,3,33,0,33
11928,False,9,10,9,0,9
11929,False,12,13,11,0,11
11930,False,12,13,4,0,4
11931,False,4,5,3,0,3
11932,False,18,19,8,0,8
11933,False,45,46,42,2,40
11934,False,15,16,12,0,12
11935,False,27,28,21,0,21
11936,False,3,4,60,0,60
11937,False,17,18,6,0,6
11938,False,11,12,1,0,1
11939,False,13,14,17,0,17
11940,False,18,19,38,5,33
11941,False,13,14,9,0,9
11942,False,6,7,12,0,12
11943,False,6,7,1,0,1
11944,False,13,14,48,1,47
11945,False,4,5,14,0,14
11946,False,4,5,5,0,5
11947,False,20,21,4,0,4
11948,False,3,4,31,0,31
11949,False,5,6,2,1,1
11950,False,14,15,6,1,5
11951,False,27,28,18,0,18
11952,False,16,17,39,2,37
11953,False,2,3,0,0,0
11954,False,4,5,81,0,81
11955,False,3,4,0,0,0
11956,False,7,8,8,0,8
11957,False,10,11,4,0,4
11958,False,10,11,24,0,24
11959,False,8,9,3,0,3
11960,False,11,12,8,0,8
11961,False,9,10,4,0,4
11962,False,3,4,1,0,1
11963,False,13,14,32,0,32
11964,False,13,14,26,1,25
11965,False,19,20,8,0,8
11966,False,6,7,5,0,5
11967,False,5,6,9,0,9
11968,False,4,5,1,0,1
11969,False,13,14,9,0,9
11970,False,11,12,1,0,1
11971,False,7,8,7,0,7
11972,False,14,15,13,0,13
11973,False,20,21,16,0,16
11974,False,26,27,18,0,18
11975,False,16,17,30,1,29
11976,False,14,15,83,0,83
11977,False,25,26,12,0,12
11978,False,30,31,47,1,46
11979,False,23,24,9,0,9
11980,False,8,9,6,0,6
11981,False,3,4,3,0,3
11982,False,12,13,32,0,32
11983,False,9,10,0,0,0
11984,False,10,11,2,0,2
11985,False,28,29,53,1,52
11986,False,17,18,23,1,22
11987,False,5,6,4,0,4
11988,False,10,11,2,1,1
11989,False,15,16,4,1,3
11990,False,7,8,2,0,2
11991,False,17,18,8,0,8
11992,False,3,4,0,0,0
11993,False,27,28,10,0,10
11994,False,12,13,17,0,17
11995,False,28,29,48,0,48
11996,False,13,14,30,0,30
11997,False,11,12,5,0,5
11998,False,10,11,4,0,4
11999,False,7,8,1,0,1
12000,False,9,10,12,0,12
12001,False,25,26,35,0,35
12002,False,10,11,3,0,3
12003,False,8,9,30,3,27
12004,False,8,9,14,0,14
12005,False,3,4,3,0,3
12006,False,21,22,9,0,9
12007,False,12,13,2,0,2
12008,False,17,18,12,0,12
12009,False,8,9,7,0,7
12010,False,7,8,11,0,11
12011,False,8,9,10,0,10
12012,False,29,30,43,0,43
12013,False,16,17,24,0,24
12014,False,8,9,20,5,15
12015,False,7,8,30,4,26
12016,False,10,11,5,0,5
12017,False,16,17,7,0,7
12018,False,14,15,6,1,5
12019,False,7,8,0,0,0
12020,False,17,18,7,1,6
12021,False,29,30,7,0,7
12022,False,18,19,9,0,9
12023,False,26,27,23,0,23
12024,False,2,3,0,0,0
12025,False,6,7,58,2,56
12026,False,8,9,1,0,1
12027,False,3,4,0,0,0
12028,False,13,14,12,0,12
12029,False,10,11,27,21,6
12030,False,10,11,28,0,28
12031,False,8,9,6,0,6
12032,False,2,3,2,0,2
12033,False,16,17,23,0,23
12034,False,21,22,7,0,7
12035,False,7,8,9,0,9
12036,False,1,2,0,0,0
12037,False,11,12,14,2,12
12038,False,7,8,57,4,53
12039,False,10,11,3,0,3
12040,False,13,14,15,0,15
12041,False,17,18,5,0,5
12042,False,15,16,19,0,19
12043,False,10,11,25,0,25
12044,False,8,9,2,0,2
12045,False,14,15,21,0,21
12046,False,9,10,17,0,17
12047,False,4,5,1,0,1
12048,False,1,2,0,0,0
12049,False,13,14,25,1,24
12050,False,7,8,33,3,30
12051,False,6,7,0,0,0
12052,False,9,10,7,0,7
12053,False,17,18,11,0,11
12054,False,7,8,8,0,8
12055,False,5,6,0,0,0
12056,False,3,4,1,0,1
12057,False,4,5,2,0,2
12058,False,17,18,34,0,34
12059,False,8,9,8,0,8
12060,False,8,9,5,0,5
12061,False,2,3,2,0,2
12062,False,8,9,7,1,6
12063,False,16,17,14,0,14
12064,False,21,22,18,0,18
12065,False,3,4,2,0,2
12066,False,9,10,9,0,9
12067,False,5,6,27,0,27
12068,False,4,5,1,0,1
12069,False,14,15,10,0,10
12070,False,13,14,27,3,24
12071,False,4,5,1,0,1
12072,False,16,17,58,0,58
12073,False,10,11,50,8,42
12074,False,13,14,6,0,6
12075,False,14,15,7,0,7
12076,False,23,24,31,1,30
12077,False,15,16,60,0,60
12078,False,23,24,76,0,76
12079,False,10,11,7,0,7
12080,False,7,8,4,0,4
12081,False,4,5,5,0,5
12082,False,10,11,31,0,31
12083,False,18,19,9,0,9
12084,False,7,8,26,10,16
12085,False,20,21,33,0,33
12086,False,21,22,15,0,15
12087,False,11,12,3,0,3
12088,False,11,12,2,2,0
12089,False,22,23,24,0,24
12090,False,6,7,2,1,1
12091,False,11,12,3,0,3
12092,False,16,17,7,0,7
12093,False,13,14,31,0,31
12094,False,13,14,13,0,13
12095,False,8,9,2,2,0
12096,False,6,7,56,2,54
12097,False,40,41,22,0,22
12098,False,9,10,1,0,1
12099,False,3,4,2,0,2
12100,False,12,13,10,0,10
12101,False,23,24,58,0,58
12102,False,10,11,7,0,7
12103,False,13,14,4,0,4
12104,False,9,10,31,0,31
12105,False,1,2,0,0,0
12106,False,16,17,3,0,3
12107,False,33,34,6,0,6
12108,False,10,11,30,5,25
12109,False,8,9,58,2,56
12110,False,14,15,17,1,16
12111,False,35,36,42,0,42
12112,False,32,33,28,0,28
12113,False,4,5,4,0,4
12114,False,22,23,6,0,6
12115,False,12,13,33,0,33
12116,False,2,3,1,0,1
12117,False,40,41,52,0,52
12118,False,3,4,0,0,0
12119,False,6,7,4,0,4
12120,False,36,37,22,0,22
12121,False,19,20,41,0,41
12122,False,33,34,37,1,36
12123,False,7,8,7,0,7
12124,False,11,12,8,0,8
12125,False,4,5,34,1,33
12126,False,9,10,32,1,31
12127,False,10,11,15,0,15
12128,False,8,9,3,0,3
12129,False,5,6,1,0,1
12130,False,8,9,5,0,5
12131,False,15,16,16,0,16
12132,False,7,8,2,1,1
12133,False,13,14,3,1,2
12134,False,5,6,3,0,3
12135,False,3,4,3,0,3
12136,False,16,17,26,0,26
12137,False,19,20,19,0,19
12138,False,12,13,3,0,3
12139,False,13,14,39,1,38
12140,False,11,12,5,0,5
12141,False,34,35,15,0,15
12142,False,34,35,31,0,31
12143,False,11,12,2,0,2
12144,False,60,61,28,1,27
12145,False,9,10,2,0,2
12146,False,33,34,6,0,6
12147,False,10,11,33,0,33
12148,False,1,2,0,0,0
12149,False,30,31,43,0,43
12150,False,3,4,0,0,0
12151,False,5,6,1,0,1
12152,False,7,8,2,0,2
12153,False,9,10,3,0,3
12154,False,24,25,28,0,28
12155,False,13,14,30,0,30
12156,False,30,31,5,0,5
12157,False,13,14,30,7,23
12158,False,19,20,22,0,22
12159,False,4,5,1,0,1
12160,False,28,29,34,0,34
12161,False,13,14,10,0,10
12162,False,13,14,4,0,4
12163,False,6,7,5,0,5
12164,False,10,11,17,1,16
12165,False,6,7,3,0,3
12166,False,18,19,9,0,9
12167,False,17,18,28,0,28
12168,False,14,15,11,0,11
12169,False,18,19,65,0,65
12170,False,23,24,40,0,40
12171,False,15,16,36,1,35
12172,False,32,33,17,0,17
12173,False,20,21,0,0,0
12174,False,7,8,5,0,5
12175,False,5,6,3,0,3
12176,False,9,10,1,1,0
12177,False,19,20,7,1,6
12178,False,14,15,9,0,9
12179,False,9,10,28,0,28
12180,False,18,19,9,0,9
12181,False,23,24,37,0,37
12182,False,13,14,8,2,6
12183,False,3,4,8,0,8
12184,False,5,6,0,0,0
12185,False,1,2,80,0,80
12186,False,18,19,26,0,26
12187,False,7,8,3,0,3
12188,False,3,4,80,0,80
12189,False,21,22,35,0,35
12190,False,14,15,8,0,8
12191,False,11,12,28,4,24
12192,False,4,5,8,0,8
12193,False,8,9,0,0,0
12194,False,13,14,5,0,5
12195,False,36,37,42,1,41
12196,False,10,11,4,0,4
12197,False,4,5,1,0,1
12198,False,15,16,12,0,12
12199,False,20,21,55,1,54
12200,False,3,4,2,0,2
12201,False,11,12,13,1,12
12202,False,5,6,0,0,0
12203,False,9,10,48,0,48
12204,False,22,23,30,0,30
12205,False,13,14,3,0,3
12206,False,5,6,1,0,1
12207,False,18,19,19,3,16
12208,False,10,11,6,0,6
12209,False,5,6,12,0,12
12210,False,3,4,2,0,2
12211,False,7,8,30,3,27
12212,False,4,5,3,1,2
12213,False,37,38,29,0,29
12214,False,1,2,0,0,0
12215,False,13,14,6,1,5
12216,False,17,18,8,0,8
12217,False,24,25,7,0,7
12218,False,14,15,11,0,11
12219,False,23,24,15,0,15
12220,False,12,13,18,0,18
12221,False,8,9,1,0,1
12222,False,7,8,1,0,1
12223,False,9,10,36,2,34
12224,False,9,10,14,0,14
12225,False,18,19,4,0,4
12226,False,8,9,5,0,5
12227,False,10,11,6,0,6
12228,False,15,16,9,0,9
12229,False,8,9,0,0,0
12230,False,7,8,2,0,2
12231,False,18,19,12,1,11
12232,False,16,17,44,0,44
12233,False,11,12,6,0,6
12234,False,13,14,10,0,10
12235,False,8,9,12,0,12
12236,False,1,2,1,0,1
12237,False,7,8,6,0,6
12238,False,4,5,3,0,3
12239,False,4,5,3,0,3
12240,False,16,17,36,1,35
12241,False,6,7,3,0,3
12242,False,12,13,10,0,10
12243,False,4,5,0,0,0
12244,False,28,29,12,0,12
12245,False,12,13,7,2,5
12246,False,2,3,6,0,6
12247,False,11,12,3,0,3
12248,False,22,23,20,0,20
12249,False,17,18,16,0,16
12250,False,5,6,2,0,2
12251,False,13,14,3,1,2
12252,False,26,27,20,0,20
12253,False,7,8,13,0,13
12254,False,24,25,29,0,29
12255,False,7,8,12,0,12
12256,False,28,29,10,1,9
12257,False,13,14,3,1,2
12258,False,11,12,1,0,1
12259,False,7,8,30,1,29
12260,False,7,8,5,0,5
12261,False,11,12,3,0,3
12262,False,7,8,0,0,0
12263,False,12,13,25,2,23
12264,False,7,8,4,0,4
12265,False,4,5,28,0,28
12266,False,4,5,3,0,3
12267,False,2,3,5,0,5
12268,False,5,6,3,0,3
12269,False,14,15,10,1,9
12270,False,28,29,22,1,21
12271,False,5,6,4,0,4
12272,False,2,3,0,0,0
12273,False,7,8,7,0,7
12274,False,5,6,5,0,5
12275,False,6,7,4,0,4
12276,False,30,31,30,0,30
12277,False,9,10,13,0,13
12278,False,2,3,4,0,4
12279,False,3,4,1,0,1
12280,False,5,6,3,1,2
12281,False,9,10,12,0,12
12282,False,9,10,6,0,6
12283,False,21,22,24,1,23
12284,False,35,36,18,0,18
12285,False,19,20,5,0,5
12286,False,7,8,58,0,58
12287,False,8,9,36,6,30
12288,False,17,18,20,0,20
12289,False,22,23,54,0,54
12290,False,28,29,42,0,42
12291,False,1,2,7,0,7
12292,False,6,7,6,0,6
12293,False,15,16,51,0,51
12294,False,11,12,29,0,29
12295,False,10,11,5,0,5
12296,False,5,6,4,0,4
12297,False,6,7,10,1,9
12298,False,4,5,0,0,0
12299,False,9,10,15,1,14
12300,False,9,10,4,0,4
12301,False,15,16,38,0,38
12302,False,6,7,39,8,31
12303,False,29,30,86,0,86
12304,False,8,9,2,0,2
12305,False,10,11,15,0,15
12306,False,7,8,7,0,7
12307,False,4,5,0,0,0
12308,False,6,7,13,0,13
12309,False,12,13,15,0,15
12310,False,9,10,13,1,12
12311,False,24,25,17,0,17
12312,False,13,14,10,0,10
12313,False,4,5,4,0,4
12314,False,10,11,7,0,7
12315,False,4,5,1,0,1
12316,False,7,8,14,0,14
12317,False,9,10,1,1,0
12318,False,10,11,57,2,55
12319,False,14,15,1,0,1
12320,False,1,2,1,0,1
12321,False,30,31,14,0,14
12322,False,7,8,7,0,7
12323,False,6,7,5,0,5
12324,False,14,15,10,0,10
12325,False,4,5,2,0,2
12326,False,9,10,8,0,8
12327,False,8,9,2,0,2
12328,False,3,4,0,0,0
12329,False,14,15,40,0,40
12330,False,8,9,6,0,6
12331,False,11,12,3,0,3
12332,False,12,13,12,1,11
12333,False,24,25,19,0,19
12334,False,8,9,0,0,0
12335,False,13,14,10,0,10
12336,False,12,13,37,12,25
12337,False,11,12,6,0,6
12338,False,21,22,32,0,32
12339,False,9,10,5,0,5
12340,False,2,3,6,0,6
12341,False,17,18,11,0,11
12342,False,28,29,5,0,5
12343,False,10,11,5,0,5
12344,False,12,13,1,0,1
12345,False,4,5,6,0,6
12346,False,3,4,2,0,2
12347,False,3,4,1,0,1
12348,False,9,10,5,0,5
12349,False,19,20,16,0,16
12350,False,2,3,4,0,4
12351,False,4,5,0,0,0
12352,False,11,12,24,0,24
12353,False,14,15,55,1,54
12354,False,8,9,6,2,4
12355,False,3,4,2,0,2
12356,False,9,10,5,0,5
12357,False,5,6,3,0,3
12358,False,6,7,4,0,4
12359,False,4,5,1,0,1
12360,False,16,17,11,0,11
12361,False,10,11,22,4,18
12362,False,4,5,3,1,2
12363,False,12,13,30,0,30
12364,False,6,7,3,0,3
12365,False,3,4,0,0,0
12366,False,8,9,6,0,6
12367,False,53,54,76,2,74
12368,False,7,8,3,0,3
12369,False,11,12,25,2,23
12370,False,14,15,7,1,6
12371,False,17,18,28,0,28
12372,False,9,10,28,4,24
12373,False,3,4,34,8,26
12374,False,19,20,10,0,10
12375,False,15,16,30,0,30
12376,False,1,2,0,0,0
12377,False,11,12,18,1,17
12378,False,23,24,5,0,5
12379,False,3,4,1,0,1
12380,False,2,3,1,1,0
12381,False,9,10,41,0,41
12382,False,15,16,23,15,8
12383,False,6,7,2,0,2
12384,False,3,4,0,0,0
12385,False,24,25,18,0,18
12386,False,23,24,50,0,50
12387,False,3,4,1,0,1
12388,False,15,16,33,0,33
12389,False,25,26,38,0,38
12390,False,7,8,4,0,4
12391,False,12,13,13,0,13
12392,False,19,20,6,0,6
12393,False,14,15,4,0,4
12394,False,17,18,7,0,7
12395,False,15,16,0,0,0
12396,False,14,15,7,0,7
12397,False,7,8,8,0,8
12398,False,22,23,28,0,28
12399,False,16,17,13,0,13
12400,False,6,7,33,1,32
12401,False,12,13,34,0,34
12402,False,6,7,1,0,1
12403,False,5,6,5,0,5
12404,False,3,4,2,0,2
12405,False,12,13,6,0,6
12406,False,6,7,5,0,5
12407,False,10,11,5,0,5
12408,False,17,18,55,0,55
12409,False,3,4,1,0,1
12410,False,13,14,9,0,9
12411,False,18,19,34,0,34
12412,False,22,23,34,0,34
12413,False,10,11,26,0,26
12414,False,7,8,24,0,24
12415,False,13,14,44,0,44
12416,False,8,9,33,1,32
12417,False,1,2,0,0,0
12418,False,16,17,6,0,6
12419,False,8,9,3,0,3
12420,False,32,33,6,0,6
12421,False,16,17,8,0,8
12422,False,1,2,2,0,2
12423,False,13,14,38,0,38
12424,False,7,8,0,0,0
12425,False,16,17,3,0,3
12426,False,5,6,63,1,62
12427,False,7,8,1,0,1
12428,False,5,6,0,0,0
12429,False,17,18,8,0,8
12430,False,4,5,4,0,4
12431,False,10,11,7,0,7
12432,False,5,6,7,0,7
12433,False,12,13,6,0,6
12434,False,19,20,28,0,28
12435,False,7,8,6,2,4
12436,False,8,9,20,4,16
12437,False,10,11,5,0,5
12438,False,8,9,2,0,2
12439,False,40,41,43,1,42
12440,False,6,7,27,0,27
12441,False,6,7,29,0,29
12442,False,1,2,0,0,0
12443,False,28,29,11,0,11
12444,False,22,23,14,1,13
12445,False,31,32,21,0,21
12446,False,17,18,11,0,11
12447,False,21,22,5,0,5
12448,False,11,12,11,0,11
12449,False,3,4,4,0,4
12450,False,2,3,6,0,6
12451,False,12,13,1,0,1
12452,False,18,19,12,0,12
12453,False,10,11,4,0,4
12454,False,7,8,0,0,0
12455,False,20,21,62,4,58
12456,False,22,23,13,0,13
12457,False,6,7,7,0,7
12458,False,20,21,19,1,18
12459,False,9,10,1,0,1
12460,False,10,11,6,0,6
12461,False,18,19,12,0,12
12462,False,33,34,85,2,83
12463,False,5,6,10,0,10
12464,False,6,7,30,1,29
12465,False,23,24,36,0,36
12466,False,8,9,7,0,7
12467,False,12,13,3,2,1
12468,False,6,7,10,0,10
12469,False,3,4,4,1,3
12470,False,9,10,3,0,3
12471,False,11,12,24,2,22
12472,False,19,20,10,0,10
12473,False,16,17,11,0,11
12474,False,3,4,28,0,28
12475,False,9,10,12,0,12
12476,False,6,7,0,0,0
12477,False,10,11,1,1,0
12478,False,2,3,3,0,3
12479,False,3,4,2,0,2
12480,False,25,26,8,1,7
12481,False,5,6,0,0,0
12482,False,7,8,5,0,5
12483,False,8,9,7,0,7
12484,False,14,15,7,0,7
12485,False,21,22,19,0,19
12486,False,1,2,1,0,1
12487,False,16,17,9,0,9
12488,False,9,10,5,0,5
12489,False,11,12,2,0,2
12490,False,12,13,61,1,60
12491,False,4,5,2,0,2
12492,False,13,14,4,0,4
12493,False,22,23,40,3,37
12494,False,26,27,37,0,37
12495,False,10,11,4,0,4
12496,False,16,17,5,2,3
12497,False,7,8,1,0,1
12498,False,7,8,8,0,8
12499,False,15,16,7,2,5
12500,False,6,7,3,0,3
12501,False,3,4,1,0,1
12502,False,6,7,55,16,39
12503,False,6,7,1,0,1
12504,False,5,6,0,0,0
12505,False,6,7,2,1,1
12506,False,8,9,2,0,2
12507,False,13,14,28,1,27
12508,False,16,17,5,0,5
12509,False,23,24,20,0,20
12510,False,21,22,14,0,14
12511,False,12,13,5,1,4
12512,False,10,11,37,0,37
12513,False,15,16,4,0,4
12514,False,26,27,19,1,18
12515,False,5,6,51,0,51
12516,False,11,12,7,0,7
12517,False,10,11,6,0,6
12518,False,9,10,6,0,6
12519,False,15,16,12,0,12
12520,False,6,7,0,0,0
12521,False,6,7,11,2,9
12522,False,8,9,1,0,1
12523,False,13,14,10,0,10
12524,False,10,11,7,0,7
12525,False,39,40,24,0,24
12526,False,27,28,33,1,32
12527,False,10,11,5,0,5
12528,False,16,17,8,0,8
12529,False,22,23,26,0,26
12530,False,10,11,10,0,10
12531,False,5,6,5,0,5
12532,False,18,19,6,0,6
12533,False,11,12,25,11,14
12534,False,10,11,3,0,3
12535,False,8,9,12,0,12
12536,False,4,5,1,0,1
12537,False,14,15,15,0,15
12538,False,21,22,7,0,7
12539,False,9,10,42,0,42
12540,False,15,16,11,0,11
12541,False,8,9,33,0,33
12542,False,21,22,19,0,19
12543,False,9,10,8,0,8
12544,False,28,29,19,0,19
12545,False,5,6,5,0,5
12546,False,9,10,5,0,5
12547,False,14,15,44,0,44
12548,False,26,27,45,0,45
12549,False,22,23,38,0,38
12550,False,4,5,4,0,4
12551,False,6,7,5,0,5
12552,False,19,20,6,0,6
12553,False,14,15,5,1,4
12554,False,27,28,37,0,37
12555,False,2,3,1,0,1
12556,False,3,4,0,0,0
12557,False,6,7,0,0,0
12558,False,11,12,23,0,23
12559,False,12,13,2,1,1
12560,False,17,18,38,0,38
12561,False,2,3,88,0,88
12562,False,2,3,2,0,2
12563,False,8,9,4,1,3
12564,False,10,11,17,0,17
12565,False,10,11,11,0,11
12566,False,3,4,2,0,2
12567,False,28,29,21,0,21
12568,False,18,19,61,1,60
12569,False,10,11,3,0,3
12570,False,12,13,4,0,4
12571,False,35,36,33,0,33
12572,False,10,11,22,1,21
12573,False,16,17,11,1,10
12574,False,7,8,28,8,20
12575,False,39,40,30,1,29
12576,False,6,7,1,0,1
12577,False,9,10,2,0,2
12578,False,9,10,32,0,32
12579,False,12,13,1,0,1
12580,False,9,10,5,1,4
12581,False,11,12,28,9,19
12582,False,18,19,8,1,7
12583,False,4,5,30,6,24
12584,False,7,8,6,0,6
12585,False,8,9,3,0,3
12586,False,6,7,7,0,7
12587,False,10,11,0,0,0
12588,False,17,18,20,0,20
12589,False,10,11,11,0,11
12590,False,7,8,5,0,5
12591,False,14,15,17,0,17
12592,False,13,14,9,0,9
12593,False,19,20,46,0,46
12594,False,17,18,5,0,5
12595,False,7,8,4,0,4
12596,False,19,20,9,0,9
12597,False,8,9,1,0,1
12598,False,4,5,27,0,27
12599,False,16,17,6,0,6
12600,False,8,9,3,0,3
12601,False,3,4,5,0,5
12602,False,6,7,34,0,34
12603,False,5,6,6,0,6
12604,False,7,8,4,1,3
12605,False,9,10,42,1,41
12606,False,4,5,2,0,2
12607,False,13,14,6,0,6
12608,False,5,6,24,0,24
12609,False,9,10,3,0,3
12610,False,11,12,56,1,55
12611,False,11,12,3,0,3
12612,False,9,10,3,0,3
12613,False,20,21,15,0,15
12614,False,6,7,8,0,8
12615,False,13,14,31,0,31
12616,False,19,20,8,0,8
12617,False,9,10,12,0,12
12618,False,25,26,19,0,19
12619,False,5,6,2,0,2
12620,False,7,8,4,0,4
12621,False,16,17,0,0,0
12622,False,15,16,3,0,3
12623,False,18,19,44,1,43
12624,False,16,17,2,0,2
12625,False,14,15,11,0,11
12626,False,15,16,30,0,30
12627,False,7,8,8,0,8
12628,False,2,3,1,0,1
12629,False,3,4,2,0,2
12630,False,2,3,0,0,0
12631,False,10,11,1,0,1
12632,False,14,15,12,0,12
12633,False,13,14,14,1,13
12634,False,14,15,8,0,8
12635,False,7,8,31,1,30
12636,False,7,8,2,0,2
12637,False,13,14,11,0,11
12638,False,10,11,35,2,33
12639,False,13,14,29,0,29
12640,False,7,8,9,2,7
12641,False,12,13,8,0,8
12642,False,8,9,4,0,4
12643,False,8,9,7,0,7
12644,False,6,7,2,0,2
12645,False,6,7,31,2,29
12646,False,30,31,61,0,61
12647,False,15,16,5,0,5
12648,False,17,18,4,0,4
12649,False,11,12,25,0,25
12650,False,17,18,13,0,13
12651,False,15,16,38,4,34
12652,False,15,16,9,0,9
12653,False,27,28,10,0,10
12654,False,11,12,5,0,5
12655,False,7,8,11,1,10
12656,False,15,16,2,0,2
12657,False,16,17,6,0,6
12658,False,3,4,3,0,3
12659,False,15,16,12,0,12
12660,False,18,19,3,0,3
12661,False,9,10,2,0,2
12662,False,17,18,3,0,3
12663,False,14,15,1,0,1
12664,False,10,11,3,0,3
12665,False,11,12,1,0,1
12666,False,21,22,17,0,17
12667,False,7,8,25,0,25
12668,False,2,3,1,0,1
12669,False,9,10,14,0,14
12670,False,16,17,11,0,11
12671,False,13,14,4,2,2
12672,False,17,18,36,3,33
12673,False,2,3,43,0,43
12674,False,9,10,8,0,8
12675,False,15,16,17,0,17
12676,False,10,11,10,0,10
12677,False,16,17,53,0,53
12678,False,7,8,5,0,5
12679,False,24,25,13,0,13
12680,False,6,7,37,3,34
12681,False,12,13,7,0,7
12682,False,3,4,3,0,3
12683,False,30,31,36,1,35
12684,False,11,12,3,0,3
12685,False,4,5,28,0,28
12686,False,1,2,0,0,0
12687,False,6,7,25,0,25
12688,False,9,10,4,0,4
12689,False,4,5,5,0,5
12690,False,6,7,5,1,4
12691,False,7,8,1,0,1
12692,False,4,5,2,0,2
12693,False,8,9,25,0,25
12694,False,14,15,5,0,5
12695,False,9,10,4,0,4
12696,False,10,11,8,0,8
12697,False,9,10,3,0,3
12698,False,12,13,14,1,13
12699,False,7,8,0,0,0
12700,False,12,13,44,17,27
12701,False,15,16,8,0,8
12702,False,7,8,0,0,0
12703,False,5,6,3,0,3
12704,False,14,15,14,1,13
12705,False,12,13,4,0,4
12706,False,10,11,16,1,15
12707,False,19,20,28,2,26
12708,False,6,7,9,0,9
12709,False,4,5,0,0,0
12710,False,7,8,3,1,2
12711,False,9,10,28,4,24
12712,False,8,9,25,0,25
12713,False,7,8,3,0,3
12714,False,11,12,5,0,5
12715,False,7,8,5,0,5
12716,False,5,6,4,0,4
12717,False,8,9,2,0,2
12718,False,5,6,5,0,5
12719,False,7,8,1,0,1
12720,False,6,7,2,0,2
12721,False,5,6,7,2,5
12722,False,8,9,10,0,10
12723,False,9,10,0,0,0
12724,False,10,11,4,0,4
12725,False,10,11,29,0,29
12726,False,8,9,5,0,5
12727,False,20,21,26,0,26
12728,False,13,14,67,1,66
12729,False,4,5,2,0,2
12730,False,14,15,28,0,28
12731,False,7,8,1,0,1
12732,False,1,2,0,0,0
12733,False,3,4,0,0,0
12734,False,14,15,8,0,8
12735,False,4,5,0,0,0
12736,False,13,14,19,0,19
12737,False,3,4,11,0,11
12738,False,7,8,4,0,4
12739,False,7,8,1,0,1
12740,False,5,6,6,0,6
12741,False,23,24,6,0,6
12742,False,5,6,1,0,1
12743,False,4,5,3,0,3
12744,False,3,4,0,0,0
12745,False,11,12,27,0,27
12746,False,32,33,24,1,23
12747,False,4,5,3,0,3
12748,False,14,15,7,1,6
12749,False,6,7,0,0,0
12750,False,11,12,1,0,1
12751,False,9,10,4,0,4
12752,False,8,9,3,1,2
12753,False,5,6,3,0,3
12754,False,17,18,6,0,6
12755,False,11,12,3,1,2
12756,False,9,10,11,4,7
12757,False,7,8,12,3,9
12758,False,17,18,7,0,7
12759,False,6,7,1,0,1
12760,False,15,16,6,0,6
12761,False,13,14,6,0,6
12762,False,5,6,1,0,1
12763,False,4,5,1,0,1
12764,False,16,17,16,2,14
12765,False,8,9,84,0,84
12766,False,3,4,5,0,5
12767,False,4,5,1,0,1
12768,False,20,21,35,3,32
12769,False,11,12,18,0,18
12770,False,3,4,0,0,0
12771,False,17,18,94,6,88
12772,False,6,7,3,0,3
12773,False,10,11,2,0,2
12774,False,5,6,3,0,3
12775,False,9,10,10,0,10
12776,False,3,4,2,0,2
12777,False,2,3,2,0,2
12778,False,12,13,7,0,7
12779,False,9,10,5,0,5
12780,False,6,7,3,0,3
12781,False,14,15,45,6,39
12782,False,18,19,11,0,11
12783,False,10,11,5,0,5
12784,False,13,14,7,0,7
12785,False,15,16,13,0,13
12786,False,9,10,6,0,6
12787,False,6,7,3,0,3
12788,False,24,25,12,0,12
12789,False,17,18,51,0,51
12790,False,6,7,4,0,4
12791,False,9,10,1,0,1
12792,False,17,18,33,0,33
12793,False,9,10,53,2,51
12794,False,42,43,26,0,26
12795,False,11,12,9,0,9
12796,False,7,8,5,0,5
12797,False,5,6,82,0,82
12798,False,7,8,3,0,3
12799,False,14,15,10,0,10
12800,False,3,4,3,0,3
12801,False,4,5,8,0,8
12802,False,10,11,3,0,3
12803,False,20,21,9,0,9
12804,False,2,3,0,0,0
12805,False,13,14,27,0,27
12806,False,5,6,2,0,2
12807,False,17,18,55,0,55
12808,False,12,13,4,0,4
12809,False,21,22,10,0,10
12810,False,21,22,55,0,55
12811,False,8,9,3,0,3
12812,False,8,9,26,0,26
12813,False,14,15,2,0,2
12814,False,2,3,0,0,0
12815,False,5,6,4,0,4
12816,False,15,16,31,0,31
12817,False,19,20,7,0,7
12818,False,5,6,71,5,66
12819,False,17,18,8,0,8
12820,False,24,25,50,3,47
12821,False,7,8,12,2,10
12822,False,6,7,28,0,28
12823,False,6,7,28,0,28
12824,False,11,12,5,0,5
12825,False,35,36,59,1,58
12826,False,31,32,22,0,22
12827,False,6,7,27,0,27
12828,False,24,25,33,0,33
12829,False,9,10,4,0,4
12830,False,15,16,5,0,5
12831,False,12,13,9,0,9
12832,False,13,14,12,0,12
12833,False,7,8,39,0,39
12834,False,17,18,3,0,3
12835,False,8,9,8,0,8
12836,False,9,10,9,0,9
12837,False,22,23,36,1,35
12838,False,10,11,7,0,7
12839,False,10,11,0,0,0
12840,False,2,3,9,0,9
12841,False,2,3,2,0,2
12842,False,16,17,6,0,6
12843,False,9,10,0,0,0
12844,False,19,20,43,0,43
12845,False,9,10,0,0,0
12846,False,14,15,4,0,4
12847,False,11,12,5,0,5
12848,False,2,3,0,0,0
12849,False,11,12,13,2,11
12850,False,17,18,14,0,14
12851,False,9,10,6,0,6
12852,False,6,7,1,0,1
12853,False,14,15,3,0,3
12854,False,6,7,5,0,5
12855,False,17,18,25,0,25
12856,False,6,7,4,1,3
12857,False,6,7,4,0,4
12858,False,5,6,28,0,28
12859,False,2,3,0,0,0
12860,False,24,25,17,0,17
12861,False,29,30,9,0,9
12862,False,5,6,3,0,3
12863,False,17,18,40,0,40
12864,False,18,19,6,0,6
12865,False,11,12,26,0,26
12866,False,4,5,28,9,19
12867,False,25,26,34,0,34
12868,False,12,13,6,2,4
12869,False,9,10,8,0,8
12870,False,11,12,2,1,1
12871,False,8,9,5,0,5
12872,False,11,12,10,0,10
12873,False,21,22,31,1,30
12874,False,12,13,5,0,5
12875,False,5,6,4,0,4
12876,False,10,11,2,1,1
12877,False,1,2,0,0,0
12878,False,16,17,33,0,33
12879,False,4,5,2,0,2
12880,False,8,9,1,0,1
12881,False,7,8,2,0,2
12882,False,2,3,2,0,2
12883,False,6,7,4,0,4
12884,False,6,7,1,0,1
12885,False,9,10,29,2,27
12886,False,20,21,9,0,9
12887,False,1,2,1,0,1
12888,False,7,8,6,0,6
12889,False,9,10,5,0,5
12890,False,3,4,2,0,2
12891,False,6,7,1,0,1
12892,False,8,9,48,0,48
12893,False,6,7,1,0,1
12894,False,11,12,56,0,56
12895,False,8,9,27,0,27
12896,False,8,9,2,0,2
12897,False,23,24,30,0,30
12898,False,10,11,7,0,7
12899,False,11,12,10,0,10
12900,False,22,23,32,1,31
12901,False,13,14,4,0,4
12902,False,32,33,11,0,11
12903,False,10,11,24,2,22
12904,False,9,10,2,0,2
12905,False,5,6,1,0,1
12906,False,12,13,54,1,53
12907,False,4,5,2,0,2
12908,False,11,12,3,0,3
12909,False,8,9,4,0,4
12910,False,11,12,3,0,3
12911,False,3,4,1,0,1
12912,False,3,4,1,0,1
12913,False,21,22,13,0,13
12914,False,10,11,3,0,3
12915,False,5,6,3,0,3
12916,False,4,5,3,0,3
12917,False,9,10,3,0,3
12918,False,6,7,8,0,8
12919,False,11,12,26,0,26
12920,False,6,7,16,0,16
12921,False,5,6,5,0,5
12922,False,9,10,3,0,3
12923,False,12,13,6,0,6
12924,False,6,7,28,0,28
12925,False,10,11,3,0,3
12926,False,10,11,15,0,15
12927,False,9,10,4,1,3
12928,False,9,10,1,0,1
12929,False,5,6,0,0,0
12930,False,14,15,3,1,2
12931,False,6,7,1,0,1
12932,False,13,14,14,0,14
12933,False,8,9,3,0,3
12934,False,10,11,4,0,4
12935,False,1,2,0,0,0
12936,False,10,11,30,0,30
12937,False,6,7,28,0,28
12938,False,13,14,41,0,41
12939,False,6,7,30,0,30
12940,False,9,10,6,0,6
12941,False,4,5,4,0,4
12942,False,12,13,2,0,2
12943,False,3,4,4,0,4
12944,False,9,10,26,1,25
12945,False,5,6,4,0,4
12946,False,5,6,2,0,2
12947,False,2,3,2,0,2
12948,False,3,4,1,0,1
12949,False,1,2,0,0,0
12950,False,6,7,2,0,2
12951,False,6,7,1,0,1
12952,False,10,11,24,8,16
12953,False,15,16,37,3,34
12954,False,8,9,32,0,32
12955,False,16,17,31,0,31
12956,False,6,7,10,0,10
12957,False,14,15,1,0,1
12958,False,10,11,5,0,5
12959,False,2,3,0,0,0
12960,False,6,7,5,0,5
12961,False,8,9,13,0,13
12962,False,11,12,3,0,3
12963,False,4,5,2,0,2
12964,False,5,6,3,0,3
12965,False,11,12,4,0,4
12966,False,6,7,16,0,16
12967,False,14,15,30,0,30
12968,False,15,16,3,0,3
12969,False,13,14,49,1,48
12970,False,5,6,32,3,29
12971,False,1,2,2,0,2
12972,False,13,14,5,0,5
12973,False,2,3,2,0,2
12974,False,13,14,3,0,3
12975,False,15,16,8,0,8
12976,False,5,6,4,0,4
12977,False,5,6,3,0,3
12978,False,8,9,2,1,1
12979,False,10,11,4,0,4
12980,False,2,3,4,0,4
12981,False,5,6,5,0,5
12982,False,9,10,6,0,6
12983,False,8,9,0,0,0
12984,False,6,7,0,0,0
12985,False,9,10,2,0,2
12986,False,7,8,2,0,2
12987,False,1,2,16,0,16
12988,False,9,10,30,0,30
12989,False,20,21,28,0,28
12990,False,1,2,0,0,0
12991,False,3,4,11,0,11
12992,False,11,12,0,0,0
12993,False,12,13,2,0,2
12994,False,12,13,4,0,4
12995,False,5,6,0,0,0
12996,False,5,6,2,0,2
12997,False,3,4,2,0,2
12998,False,7,8,3,0,3
12999,False,5,6,3,0,3
13000,False,9,10,3,1,2
13001,False,8,9,34,2,32
13002,False,3,4,0,0,0
13003,False,7,8,3,0,3
13004,False,10,11,2,0,2
13005,False,2,3,1,0,1
13006,False,6,7,5,0,5
13007,False,10,11,3,0,3
13008,False,13,14,35,0,35
13009,False,2,3,0,0,0
13010,False,4,5,1,0,1
13011,False,19,20,5,0,5
13012,False,10,11,16,0,16
13013,False,6,7,2,0,2
13014,False,7,8,5,0,5
13015,False,6,7,1,0,1
13016,False,6,7,6,0,6
13017,False,25,26,11,0,11
13018,False,4,5,5,0,5
13019,False,8,9,5,0,5
13020,False,1,2,0,0,0
13021,False,1,2,0,0,0
13022,False,12,13,28,0,28
13023,False,9,10,13,0,13
13024,False,2,3,2,0,2
13025,False,10,11,1,0,1
13026,False,19,20,35,0,35
13027,False,6,7,31,1,30
13028,False,4,5,2,0,2
13029,False,22,23,11,0,11
13030,False,15,16,36,0,36
13031,False,9,10,13,0,13
13032,False,7,8,5,0,5
13033,False,12,13,5,0,5
13034,False,6,7,4,0,4
13035,False,29,30,19,0,19
13036,False,1,2,0,0,0
13037,False,8,9,6,0,6
13038,False,5,6,6,0,6
13039,False,11,12,3,1,2
13040,False,9,10,41,0,41
13041,False,4,5,4,2,2
13042,False,2,3,0,0,0
13043,False,3,4,1,0,1
13044,False,7,8,1,0,1
13045,False,8,9,4,0,4
13046,False,18,19,18,0,18
13047,False,8,9,6,0,6
13048,False,2,3,2,0,2
13049,False,9,10,23,9,14
13050,False,4,5,2,1,1
13051,False,17,18,12,0,12
13052,False,3,4,2,0,2
13053,False,6,7,3,0,3
13054,False,9,10,2,0,2
13055,False,8,9,30,2,28
13056,False,13,14,8,2,6
13057,False,8,9,3,3,0
13058,False,24,25,40,0,40
13059,False,4,5,26,0,26
13060,False,3,4,22,0,22
13061,False,2,3,3,0,3
13062,False,3,4,1,0,1
13063,False,15,16,15,0,15
13064,False,2,3,2,0,2
13065,False,26,27,13,0,13
13066,False,8,9,32,1,31
13067,False,10,11,6,0,6
13068,False,24,25,34,1,33
13069,False,6,7,6,0,6
13070,False,6,7,30,0,30
13071,False,13,14,6,0,6
13072,False,6,7,15,1,14
13073,False,6,7,32,1,31
13074,False,3,4,1,0,1
13075,False,15,16,15,2,13
13076,False,2,3,2,0,2
13077,False,4,5,27,0,27
13078,False,19,20,19,0,19
13079,False,9,10,28,0,28
13080,False,4,5,0,0,0
13081,False,6,7,4,0,4
13082,False,4,5,3,0,3
13083,False,4,5,2,0,2
13084,False,11,12,2,0,2
13085,False,14,15,5,0,5
13086,False,4,5,1,0,1
13087,False,11,12,13,0,13
13088,False,6,7,10,0,10
13089,False,8,9,37,7,30
13090,False,8,9,23,2,21
13091,False,6,7,4,0,4
13092,False,8,9,7,0,7
13093,False,8,9,6,0,6
13094,False,10,11,6,0,6
13095,False,7,8,3,0,3
13096,False,8,9,6,0,6
13097,False,4,5,2,0,2
13098,False,5,6,2,1,1
13099,False,7,8,5,0,5
13100,False,11,12,7,0,7
13101,False,7,8,3,0,3
13102,False,5,6,25,0,25
13103,False,5,6,1,0,1
13104,False,11,12,11,0,11
13105,False,5,6,10,1,9
13106,False,18,19,22,4,18
13107,False,4,5,2,0,2
13108,False,3,4,3,0,3
13109,False,4,5,3,0,3
13110,False,4,5,0,0,0
13111,False,6,7,31,0,31
13112,False,7,8,38,1,37
13113,False,9,10,3,0,3
13114,False,6,7,29,0,29
13115,False,16,17,20,0,20
13116,False,1,2,0,0,0
13117,False,5,6,4,0,4
13118,False,5,6,0,0,0
13119,False,11,12,1,0,1
13120,False,8,9,27,0,27
13121,False,8,9,12,0,12
13122,False,8,9,25,3,22
13123,False,1,2,1,0,1
13124,False,9,10,4,0,4
13125,False,3,4,0,0,0
13126,False,4,5,2,0,2
13127,False,1,2,0,0,0
13128,False,3,4,3,0,3
13129,False,7,8,20,1,19
13130,False,5,6,1,1,0
13131,False,6,7,30,0,30
13132,False,21,22,13,0,13
13133,False,9,10,29,0,29
13134,False,11,12,24,1,23
13135,False,8,9,9,0,9
13136,False,7,8,51,0,51
13137,False,11,12,28,0,28
13138,False,7,8,2,2,0
13139,False,8,9,3,0,3
13140,False,5,6,3,0,3
13141,False,4,5,0,0,0
13142,False,10,11,9,7,2
13143,False,18,19,8,0,8
13144,False,5,6,1,0,1
13145,False,8,9,26,0,26
13146,False,5,6,4,0,4
13147,False,5,6,2,0,2
13148,False,12,13,9,0,9
13149,False,16,17,2,0,2
13150,False,6,7,1,1,0
13151,False,10,11,32,5,27
13152,False,7,8,6,0,6
13153,False,14,15,6,0,6
13154,False,4,5,2,0,2
13155,False,4,5,1,0,1
13156,False,10,11,1,0,1
13157,False,13,14,25,2,23
13158,False,8,9,1,1,0
13159,False,4,5,10,2,8
13160,False,10,11,7,0,7
13161,False,20,21,20,1,19
13162,False,15,16,4,0,4
13163,False,15,16,30,1,29
13164,False,11,12,1,1,0
13165,False,7,8,3,0,3
13166,False,13,14,6,0,6
13167,False,4,5,0,0,0
13168,False,11,12,6,0,6
13169,False,10,11,7,0,7
13170,False,18,19,14,1,13
13171,False,2,3,1,0,1
13172,False,5,6,5,0,5
13173,False,9,10,4,0,4
13174,False,1,2,5,0,5
13175,False,2,3,1,0,1
13176,False,13,14,8,0,8
13177,False,18,19,17,0,17
13178,False,9,10,7,0,7
13179,False,8,9,34,0,34
13180,False,4,5,1,0,1
13181,False,8,9,0,0,0
13182,False,5,6,4,0,4
13183,False,9,10,3,1,2
13184,False,8,9,6,2,4
13185,False,2,3,4,0,4
13186,False,11,12,5,0,5
13187,False,6,7,0,0,0
13188,False,10,11,2,0,2
13189,False,9,10,4,2,2
13190,False,9,10,0,0,0
13191,False,6,7,2,0,2
13192,False,10,11,4,0,4
13193,False,1,2,0,0,0
13194,False,9,10,1,0,1
13195,False,15,16,6,0,6
13196,False,8,9,3,0,3
13197,False,7,8,5,1,4
13198,False,6,7,30,0,30
13199,False,11,12,0,0,0
13200,False,8,9,1,0,1
13201,False,5,6,1,0,1
13202,False,1,2,80,0,80
13203,False,2,3,0,0,0
13204,False,5,6,0,0,0
13205,False,9,10,1,0,1
13206,False,13,14,25,0,25
13207,False,4,5,5,0,5
13208,False,6,7,0,0,0
13209,False,11,12,14,0,14
13210,False,15,16,36,0,36
13211,False,7,8,3,0,3
13212,False,11,12,12,0,12
13213,False,6,7,2,0,2
13214,False,13,14,1,0,1
13215,False,5,6,3,0,3
13216,False,11,12,8,0,8
13217,False,15,16,0,0,0
13218,False,5,6,1,0,1
13219,False,10,11,7,1,6
13220,False,11,12,6,0,6
13221,False,14,15,2,0,2
13222,False,12,13,1,0,1
13223,False,9,10,6,0,6
13224,False,11,12,4,0,4
13225,False,11,12,1,0,1
13226,False,1,2,0,0,0
13227,False,7,8,28,0,28
13228,False,9,10,3,0,3
13229,False,5,6,1,0,1
13230,False,17,18,6,0,6
13231,False,2,3,3,0,3
13232,False,3,4,0,0,0
13233,False,2,3,76,5,71
13234,False,16,17,8,0,8
13235,False,11,12,4,0,4
13236,False,4,5,1,0,1
13237,False,7,8,14,0,14
13238,False,7,8,1,0,1
13239,False,13,14,3,0,3
13240,False,12,13,1,1,0
13241,False,8,9,0,0,0
13242,False,8,9,27,0,27
13243,False,5,6,1,0,1
13244,False,14,15,4,0,4
13245,False,2,3,40,7,33
13246,False,4,5,3,0,3
13247,False,1,2,3,0,3
13248,False,13,14,57,10,47
13249,False,5,6,3,1,2
13250,False,7,8,1,0,1
13251,False,5,6,32,0,32
13252,False,9,10,9,0,9
13253,False,3,4,6,0,6
13254,False,10,11,74,0,74
13255,False,7,8,0,0,0
13256,False,5,6,2,0,2
13257,False,11,12,4,1,3
13258,False,3,4,6,0,6
13259,False,6,7,3,0,3
13260,False,1,2,80,0,80
13261,False,21,22,14,1,13
13262,False,14,15,8,0,8
13263,False,16,17,11,0,11
13264,False,6,7,0,0,0
13265,False,2,3,0,0,0
13266,False,6,7,1,0,1
13267,False,3,4,3,0,3
13268,False,6,7,3,0,3
13269,False,9,10,4,1,3
13270,False,15,16,14,2,12
13271,False,3,4,8,0,8
13272,False,18,19,5,0,5
13273,False,13,14,11,1,10
13274,False,1,2,0,0,0
13275,False,9,10,4,0,4
13276,False,10,11,2,0,2
13277,False,4,5,24,0,24
13278,False,9,10,43,0,43
13279,False,6,7,5,0,5
13280,False,8,9,4,1,3
13281,False,5,6,3,2,1
13282,False,8,9,2,1,1
13283,False,5,6,28,0,28
13284,False,2,3,4,0,4
13285,False,9,10,43,0,43
13286,False,1,2,0,0,0
13287,False,7,8,6,0,6
13288,False,8,9,4,0,4
13289,False,4,5,1,0,1
13290,False,3,4,6,1,5
13291,False,16,17,14,0,14
13292,False,3,4,3,0,3
13293,False,11,12,5,0,5
13294,False,6,7,32,1,31
13295,False,5,6,2,0,2
13296,False,9,10,3,0,3
13297,False,11,12,6,0,6
13298,False,4,5,7,0,7
13299,False,15,16,12,1,11
13300,False,10,11,9,0,9
13301,False,14,15,5,0,5
13302,False,1,2,0,0,0
13303,False,10,11,3,0,3
13304,False,6,7,1,0,1
13305,False,6,7,3,0,3
13306,False,6,7,21,0,21
13307,False,7,8,7,0,7
13308,False,12,13,3,2,1
13309,False,1,2,0,0,0
13310,False,15,16,26,2,24
13311,False,11,12,7,0,7
13312,False,4,5,3,0,3
13313,False,2,3,2,0,2
13314,False,7,8,1,0,1
13315,False,9,10,48,1,47
13316,False,9,10,3,0,3
13317,False,5,6,0,0,0
13318,False,9,10,1,1,0
13319,False,3,4,6,0,6
13320,False,3,4,1,0,1
13321,False,5,6,4,0,4
13322,False,8,9,2,0,2
13323,False,9,10,1,0,1
13324,False,3,4,90,4,86
13325,False,1,2,0,0,0
13326,False,3,4,2,0,2
13327,False,5,6,2,0,2
13328,False,2,3,0,0,0
13329,False,7,8,5,0,5
13330,False,3,4,1,0,1
13331,False,5,6,24,5,19
13332,False,1,2,1,0,1
13333,False,9,10,1,1,0
13334,False,11,12,2,0,2
13335,False,3,4,0,0,0
13336,False,10,11,13,1,12
13337,False,17,18,14,1,13
13338,False,8,9,10,0,10
13339,False,5,6,5,0,5
13340,False,7,8,0,0,0
13341,False,3,4,0,0,0
13342,False,6,7,33,10,23
13343,False,9,10,29,0,29
13344,False,3,4,1,0,1
13345,False,12,13,32,0,32
13346,False,4,5,13,5,8
13347,False,3,4,31,8,23
13348,False,5,6,4,0,4
13349,False,2,3,0,0,0
13350,False,8,9,23,3,20
13351,False,3,4,3,0,3
13352,False,2,3,0,0,0
13353,False,4,5,1,0,1
13354,False,8,9,0,0,0
13355,False,2,3,0,0,0
13356,False,6,7,1,0,1
13357,False,7,8,2,0,2
13358,False,11,12,10,0,10
13359,False,6,7,4,0,4
13360,False,3,4,42,9,33
13361,False,4,5,0,0,0
13362,False,3,4,3,0,3
13363,False,24,25,20,0,20
13364,False,5,6,32,2,30
13365,False,4,5,3,0,3
13366,False,8,9,4,0,4
13367,False,13,14,12,0,12
13368,False,7,8,3,0,3
13369,False,3,4,4,0,4
13370,False,7,8,26,2,24
13371,False,9,10,8,0,8
13372,False,8,9,2,0,2
13373,False,7,8,4,0,4
13374,False,3,4,2,0,2
13375,False,5,6,3,1,2
13376,False,2,3,0,0,0
13377,False,3,4,5,0,5
13378,False,4,5,0,0,0
13379,False,8,9,9,0,9
13380,False,7,8,3,0,3
13381,False,13,14,5,0,5
13382,False,9,10,3,0,3
13383,False,11,12,32,1,31
13384,False,5,6,0,0,0
13385,False,7,8,7,0,7
13386,False,8,9,9,0,9
13387,False,3,4,4,0,4
13388,False,2,3,8,0,8
13389,False,21,22,35,0,35
13390,False,1,2,1,0,1
13391,False,1,2,2,0,2
13392,False,11,12,7,0,7
13393,False,10,11,3,1,2
13394,False,8,9,5,0,5
13395,False,4,5,30,0,30
13396,False,2,3,0,0,0
13397,False,3,4,0,0,0
13398,False,4,5,1,0,1
13399,False,18,19,33,0,33
13400,False,12,13,11,0,11
13401,False,7,8,50,1,49
13402,False,3,4,28,1,27
13403,False,8,9,0,0,0
13404,False,2,3,0,0,0
13405,False,5,6,0,0,0
13406,False,1,2,0,0,0
13407,False,9,10,6,0,6
13408,False,6,7,3,0,3
13409,False,11,12,4,0,4
13410,False,5,6,27,1,26
13411,False,12,13,8,0,8
13412,False,1,2,0,0,0
13413,False,7,8,11,1,10
13414,False,15,16,34,0,34
13415,False,6,7,0,0,0
13416,False,7,8,11,0,11
13417,False,16,17,11,0,11
13418,False,7,8,5,0,5
13419,False,15,16,13,0,13
13420,False,12,13,28,0,28
13421,False,10,11,47,0,47
13422,False,1,2,0,0,0
13423,False,6,7,0,0,0
13424,False,15,16,65,0,65
13425,False,11,12,0,0,0
13426,False,16,17,7,0,7
13427,False,13,14,2,1,1
13428,False,7,8,12,0,12
13429,False,4,5,1,0,1
13430,False,2,3,0,0,0
13431,False,5,6,3,0,3
13432,False,2,3,1,0,1
13433,False,4,5,32,1,31
13434,False,7,8,2,0,2
13435,False,7,8,2,0,2
13436,False,16,17,10,0,10
13437,False,3,4,2,0,2
13438,False,11,12,12,0,12
13439,False,11,12,0,0,0
13440,False,4,5,0,0,0
13441,False,1,2,1,0,1
13442,False,5,6,1,0,1
13443,False,6,7,37,0,37
13444,False,6,7,3,0,3
13445,False,13,14,0,0,0
13446,False,1,2,1,0,1
13447,False,6,7,36,0,36
13448,False,2,3,2,0,2
13449,False,7,8,76,2,74
13450,False,17,18,11,0,11
13451,False,6,7,4,0,4
13452,False,5,6,0,0,0
13453,False,3,4,0,0,0
13454,False,10,11,11,0,11
13455,False,16,17,6,0,6
13456,False,3,4,1,0,1
13457,False,3,4,2,0,2
13458,False,13,14,28,2,26
13459,False,3,4,3,0,3
13460,False,4,5,4,0,4
13461,False,5,6,3,0,3
13462,False,8,9,5,0,5
13463,False,10,11,8,0,8
13464,False,10,11,17,0,17
13465,False,6,7,2,0,2
13466,False,5,6,3,0,3
13467,False,4,5,27,0,27
13468,False,5,6,35,11,24
13469,False,9,10,8,0,8
13470,False,5,6,0,0,0
13471,False,2,3,3,0,3
13472,False,21,22,10,0,10
13473,False,8,9,38,0,38
13474,False,8,9,8,1,7
13475,False,1,2,0,0,0
13476,False,2,3,2,0,2
13477,False,10,11,8,0,8
13478,False,4,5,0,0,0
13479,False,5,6,1,0,1
13480,False,9,10,4,0,4
13481,False,4,5,0,0,0
13482,False,16,17,7,0,7
13483,False,7,8,5,0,5
13484,False,14,15,48,4,44
13485,False,13,14,4,0,4
13486,False,10,11,5,0,5
13487,False,4,5,0,0,0
13488,False,8,9,3,0,3
13489,False,10,11,31,0,31
13490,False,6,7,6,0,6
13491,False,3,4,0,0,0
13492,False,5,6,1,0,1
13493,False,3,4,1,0,1
13494,False,6,7,0,0,0
13495,False,6,7,0,0,0
13496,False,12,13,28,1,27
13497,False,3,4,2,0,2
13498,False,12,13,9,0,9
13499,False,8,9,15,0,15
13500,False,6,7,2,0,2
13501,False,7,8,2,0,2
13502,False,5,6,2,0,2
13503,False,8,9,27,0,27
13504,False,11,12,3,0,3
13505,False,5,6,2,0,2
13506,False,7,8,3,0,3
13507,False,5,6,1,0,1
13508,False,4,5,1,0,1
13509,False,1,2,0,0,0
13510,False,9,10,9,0,9
13511,False,11,12,0,0,0
13512,False,18,19,32,0,32
13513,False,2,3,1,0,1
13514,False,12,13,0,0,0
13515,False,5,6,2,0,2
13516,False,3,4,0,0,0
13517,False,3,4,2,0,2
13518,False,16,17,61,1,60
13519,False,2,3,2,0,2
13520,False,6,7,1,0,1
13521,False,7,8,6,0,6
13522,False,11,12,4,0,4
13523,False,3,4,3,0,3
13524,False,8,9,0,0,0
13525,False,4,5,1,0,1
13526,False,5,6,4,0,4
13527,False,7,8,7,0,7
13528,False,2,3,0,0,0
13529,False,8,9,4,0,4
13530,False,9,10,8,0,8
13531,False,10,11,48,0,48
13532,False,6,7,3,0,3
13533,False,6,7,4,1,3
13534,False,7,8,6,0,6
13535,False,6,7,3,0,3
13536,False,7,8,2,0,2
13537,False,6,7,1,0,1
13538,False,5,6,1,0,1
13539,False,8,9,2,0,2
13540,False,2,3,2,0,2
13541,False,2,3,0,0,0
13542,False,1,2,0,0,0
13543,False,7,8,5,0,5
13544,False,1,2,0,0,0
13545,False,11,12,51,0,51
13546,False,18,19,41,3,38
13547,False,3,4,0,0,0
13548,False,5,6,4,0,4
13549,False,7,8,1,0,1
13550,False,4,5,2,0,2
13551,False,3,4,3,0,3
13552,False,3,4,2,0,2
13553,False,5,6,30,1,29
13554,False,4,5,5,0,5
13555,False,6,7,0,0,0
13556,False,7,8,5,0,5
13557,False,3,4,36,0,36
13558,False,11,12,0,0,0
13559,False,3,4,1,0,1
13560,False,3,4,4,0,4
13561,False,16,17,6,0,6
13562,False,10,11,4,1,3
13563,False,6,7,5,0,5
13564,False,9,10,4,0,4
13565,False,22,23,10,0,10
13566,False,10,11,2,0,2
13567,False,5,6,3,0,3
13568,False,1,2,1,0,1
13569,False,1,2,0,0,0
13570,False,5,6,40,0,40
13571,False,3,4,0,0,0
13572,False,7,8,4,0,4
13573,False,2,3,1,0,1
13574,False,6,7,0,0,0
13575,False,8,9,6,0,6
13576,False,8,9,5,0,5
13577,False,2,3,1,0,1
13578,False,7,8,5,0,5
13579,False,8,9,6,0,6
13580,False,4,5,2,0,2
13581,False,3,4,1,0,1
13582,False,5,6,3,0,3
13583,False,3,4,34,0,34
13584,False,8,9,26,0,26
13585,False,11,12,27,1,26
13586,False,7,8,3,0,3
13587,False,2,3,4,0,4
13588,False,4,5,0,0,0
13589,False,5,6,4,0,4
13590,False,6,7,0,0,0
13591,False,7,8,5,0,5
13592,False,7,8,2,0,2
13593,False,13,14,28,1,27
13594,False,6,7,5,0,5
13595,False,8,9,6,0,6
13596,False,6,7,50,0,50
13597,False,8,9,10,0,10
13598,False,2,3,4,0,4
13599,False,11,12,25,0,25
13600,False,3,4,0,0,0
13601,False,7,8,4,0,4
13602,False,3,4,2,0,2
13603,False,21,22,10,0,10
13604,False,18,19,26,0,26
13605,False,6,7,2,0,2
13606,False,5,6,48,27,21
13607,False,10,11,7,0,7
13608,False,10,11,5,0,5
13609,False,9,10,11,2,9
13610,False,2,3,0,0,0
13611,False,5,6,3,0,3
13612,False,7,8,6,0,6
13613,False,8,9,4,0,4
13614,False,7,8,4,0,4
13615,False,6,7,28,0,28
13616,False,2,3,9,0,9
13617,False,5,6,53,1,52
13618,False,5,6,8,1,7
13619,False,14,15,7,0,7
13620,False,15,16,29,1,28
13621,False,8,9,3,0,3
13622,False,3,4,0,0,0
13623,False,5,6,4,0,4
13624,False,4,5,3,0,3
13625,False,9,10,0,0,0
13626,False,8,9,12,0,12
13627,False,2,3,2,0,2
13628,False,5,6,15,2,13
13629,False,4,5,4,0,4
13630,False,3,4,2,0,2
13631,False,13,14,3,0,3
13632,False,14,15,2,0,2
13633,False,9,10,4,0,4
13634,False,4,5,8,0,8
13635,False,3,4,0,0,0
13636,False,12,13,3,0,3
13637,False,6,7,3,0,3
13638,False,2,3,1,0,1
13639,False,10,11,7,0,7
13640,False,5,6,3,0,3
13641,False,4,5,0,0,0
13642,False,2,3,1,0,1
13643,False,7,8,6,0,6
13644,False,8,9,8,0,8
13645,False,13,14,75,0,75
13646,False,3,4,3,0,3
13647,False,11,12,11,0,11
13648,False,4,5,0,0,0
13649,False,4,5,1,0,1
13650,False,14,15,33,0,33
13651,False,3,4,32,0,32
13652,False,4,5,2,0,2
13653,False,1,2,2,0,2
13654,False,5,6,4,0,4
13655,False,8,9,25,0,25
13656,False,1,2,80,0,80
13657,False,11,12,3,0,3
13658,False,4,5,5,0,5
13659,False,14,15,19,2,17
13660,False,6,7,3,0,3
13661,False,4,5,29,0,29
13662,False,13,14,1,0,1
13663,False,16,17,0,0,0
13664,False,9,10,4,0,4
13665,False,3,4,0,0,0
13666,False,19,20,2,0,2
13667,False,3,4,3,0,3
13668,False,9,10,35,3,32
13669,False,1,2,0,0,0
13670,False,13,14,10,0,10
13671,False,7,8,4,0,4
13672,False,13,14,35,3,32
13673,False,12,13,36,1,35
13674,False,4,5,2,0,2
13675,False,7,8,6,0,6
13676,False,6,7,4,0,4
13677,False,6,7,9,2,7
13678,False,4,5,6,0,6
13679,False,3,4,0,0,0
13680,False,14,15,7,1,6
13681,False,13,14,9,0,9
13682,False,13,14,36,0,36
13683,False,5,6,0,0,0
13684,False,1,2,0,0,0
13685,False,4,5,4,0,4
13686,False,8,9,4,0,4
13687,False,1,2,1,0,1
13688,False,9,10,7,0,7
13689,False,3,4,9,0,9
13690,False,4,5,0,0,0
13691,False,5,6,5,0,5
13692,False,5,6,1,0,1
13693,False,3,4,5,0,5
13694,False,7,8,8,0,8
13695,False,1,2,5,0,5
13696,False,3,4,3,0,3
13697,False,4,5,38,1,37
13698,False,7,8,9,0,9
13699,False,12,13,1,0,1
13700,False,5,6,5,1,4
13701,False,2,3,1,0,1
13702,False,2,3,0,0,0
13703,False,5,6,40,0,40
13704,False,9,10,5,0,5
13705,False,3,4,7,1,6
13706,False,7,8,3,0,3
13707,False,5,6,1,1,0
13708,False,12,13,46,5,41
13709,False,6,7,2,0,2
13710,False,7,8,0,0,0
13711,False,5,6,7,0,7
13712,False,1,2,80,0,80
13713,False,4,5,34,0,34
13714,False,3,4,0,0,0
13715,False,12,13,6,0,6
13716,False,2,3,3,0,3
13717,False,10,11,4,0,4
13718,False,3,4,3,0,3
13719,False,7,8,3,0,3
13720,False,2,3,1,0,1
13721,False,7,8,8,0,8
13722,False,10,11,4,0,4
13723,False,6,7,29,0,29
13724,False,2,3,2,0,2
13725,False,6,7,25,0,25
13726,False,1,2,1,0,1
13727,False,22,23,15,0,15
13728,False,8,9,22,13,9
13729,False,3,4,0,0,0
13730,False,3,4,2,0,2
13731,False,8,9,0,0,0
13732,False,1,2,0,0,0
13733,False,4,5,3,0,3
13734,False,10,11,8,2,6
13735,False,2,3,45,0,45
13736,False,4,5,0,0,0
13737,False,11,12,28,13,15
13738,False,2,3,1,0,1
13739,False,5,6,2,0,2
13740,False,7,8,0,0,0
13741,False,5,6,5,0,5
13742,False,10,11,44,2,42
13743,False,9,10,27,0,27
13744,False,6,7,10,0,10
13745,False,8,9,1,0,1
13746,False,4,5,6,0,6
13747,False,3,4,2,0,2
13748,False,14,15,4,0,4
13749,False,4,5,2,0,2
13750,False,1,2,0,0,0
13751,False,6,7,3,0,3
13752,False,11,12,0,0,0
13753,False,3,4,0,0,0
13754,False,6,7,1,0,1
13755,False,5,6,0,0,0
13756,False,3,4,1,0,1
13757,False,4,5,1,0,1
13758,False,1,2,1,0,1
13759,False,4,5,9,0,9
13760,False,3,4,0,0,0
13761,False,6,7,4,0,4
13762,False,3,4,6,0,6
13763,False,11,12,31,0,31
13764,False,1,2,0,0,0
13765,False,4,5,5,0,5
13766,False,2,3,1,0,1
13767,False,2,3,3,0,3
13768,False,3,4,35,0,35
13769,False,5,6,4,0,4
13770,False,15,16,7,0,7
13771,False,5,6,6,2,4
13772,False,2,3,1,0,1
13773,False,1,2,0,0,0
13774,False,7,8,4,0,4
13775,False,13,14,3,0,3
13776,False,3,4,2,0,2
13777,False,7,8,92,1,91
13778,False,7,8,2,0,2
13779,False,4,5,2,0,2
13780,False,1,2,0,0,0
13781,False,1,2,0,0,0
13782,False,4,5,3,0,3
13783,False,11,12,1,0,1
13784,False,4,5,1,0,1
13785,False,5,6,3,0,3
13786,False,13,14,7,0,7
13787,False,5,6,5,0,5
13788,False,14,15,4,0,4
13789,False,11,12,10,0,10
13790,False,1,2,0,0,0
13791,False,7,8,31,0,31
13792,False,12,13,2,0,2
13793,False,3,4,3,0,3
13794,False,20,21,16,0,16
13795,False,1,2,0,0,0
13796,False,2,3,0,0,0
13797,False,1,2,8,0,8
13798,False,4,5,3,0,3
13799,False,5,6,2,0,2
13800,False,7,8,7,0,7
13801,False,12,13,6,0,6
13802,False,3,4,0,0,0
13803,False,2,3,2,0,2
13804,False,6,7,0,0,0
13805,False,7,8,2,0,2
13806,False,3,4,0,0,0
13807,False,3,4,0,0,0
13808,False,6,7,5,0,5
13809,False,6,7,39,0,39
13810,False,9,10,1,0,1
13811,False,4,5,0,0,0
13812,False,11,12,30,0,30
13813,False,10,11,5,0,5
13814,False,1,2,0,0,0
13815,False,4,5,5,0,5
13816,False,1,2,0,0,0
13817,False,7,8,1,0,1
13818,False,3,4,38,0,38
13819,False,10,11,0,0,0
13820,False,9,10,23,0,23
13821,False,2,3,81,0,81
13822,False,4,5,3,0,3
13823,False,2,3,0,0,0
13824,False,2,3,0,0,0
13825,False,1,2,0,0,0
13826,False,6,7,0,0,0
13827,False,3,4,2,0,2
13828,False,5,6,5,0,5
13829,False,5,6,0,0,0
13830,False,1,2,1,0,1
13831,False,5,6,7,0,7
13832,False,1,2,0,0,0
13833,False,3,4,0,0,0
13834,False,3,4,28,0,28
13835,False,19,20,30,1,29
13836,False,4,5,2,0,2
13837,False,5,6,3,0,3
13838,False,3,4,2,0,2
13839,False,2,3,0,0,0
13840,False,10,11,61,4,57
13841,False,1,2,1,0,1
13842,False,8,9,3,0,3
13843,False,8,9,5,0,5
13844,False,3,4,2,0,2
13845,False,12,13,6,0,6
13846,False,4,5,81,0,81
13847,False,2,3,0,0,0
13848,False,11,12,30,1,29
13849,False,6,7,0,0,0
13850,False,2,3,0,0,0
13851,False,7,8,2,0,2
13852,False,3,4,1,0,1
13853,False,14,15,53,3,50
13854,False,14,15,8,0,8
13855,False,3,4,0,0,0
13856,False,3,4,1,0,1
13857,False,2,3,0,0,0
13858,False,1,2,0,0,0
13859,False,7,8,2,0,2
13860,False,6,7,2,0,2
13861,False,1,2,0,0,0
13862,False,11,12,6,0,6
13863,False,7,8,4,0,4
13864,False,6,7,6,0,6
13865,False,5,6,6,0,6
13866,False,1,2,0,0,0
13867,False,9,10,14,0,14
13868,False,1,2,1,0,1
13869,False,2,3,3,0,3
13870,False,6,7,39,0,39
13871,False,3,4,2,0,2
13872,False,7,8,0,0,0
13873,False,4,5,9,2,7
13874,False,5,6,36,0,36
13875,False,9,10,29,0,29
13876,False,1,2,0,0,0
13877,False,2,3,2,0,2
13878,False,3,4,1,0,1
13879,False,5,6,2,0,2
13880,False,2,3,1,0,1
13881,False,7,8,3,0,3
13882,False,3,4,5,0,5
13883,False,7,8,3,1,2
13884,False,7,8,5,0,5
13885,False,8,9,12,1,11
13886,False,1,2,0,0,0
13887,False,6,7,0,0,0
13888,False,9,10,24,11,13
13889,False,7,8,0,0,0
13890,False,3,4,9,0,9
13891,False,6,7,5,0,5
13892,False,1,2,3,0,3
13893,False,4,5,0,0,0
13894,False,1,2,0,0,0
13895,False,1,2,0,0,0
13896,False,9,10,17,4,13
13897,False,2,3,2,0,2
13898,False,4,5,2,0,2
13899,False,3,4,5,0,5
13900,False,2,3,6,0,6
13901,False,6,7,2,0,2
13902,False,5,6,2,0,2
13903,False,2,3,1,0,1
13904,False,3,4,31,0,31
13905,False,13,14,16,0,16
13906,False,5,6,10,0,10
13907,False,1,2,3,0,3
13908,False,3,4,1,0,1
13909,False,2,3,0,0,0
13910,False,1,2,1,0,1
13911,False,3,4,4,0,4
13912,False,6,7,4,0,4
13913,False,3,4,0,0,0
13914,False,9,10,6,0,6
13915,False,1,2,0,0,0
13916,False,8,9,2,0,2
13917,False,2,3,1,1,0
13918,False,2,3,0,0,0
13919,False,3,4,5,0,5
13920,False,6,7,0,0,0
13921,False,6,7,1,0,1
13922,False,2,3,0,0,0
13923,False,11,12,19,0,19
13924,False,5,6,4,0,4
13925,False,4,5,8,0,8
13926,False,3,4,2,0,2
13927,False,15,16,26,2,24
13928,False,16,17,10,1,9
13929,False,6,7,0,0,0
13930,False,5,6,30,0,30
13931,False,5,6,3,0,3
13932,False,19,20,17,0,17
13933,False,1,2,4,0,4
13934,False,3,4,0,0,0
13935,False,7,8,3,0,3
13936,False,3,4,3,0,3
13937,False,3,4,6,0,6
13938,False,1,2,1,0,1
13939,False,4,5,29,0,29
13940,False,4,5,5,0,5
13941,False,7,8,4,0,4
13942,False,1,2,80,0,80
13943,False,1,2,0,0,0
13944,False,5,6,10,0,10
13945,False,2,3,12,0,12
13946,False,7,8,7,0,7
13947,False,6,7,5,1,4
13948,False,5,6,2,0,2
13949,False,2,3,0,0,0
13950,False,7,8,27,1,26
13951,False,10,11,29,0,29
13952,False,5,6,1,0,1
13953,False,9,10,11,0,11
13954,False,1,2,1,0,1
13955,False,14,15,6,0,6
13956,False,1,2,0,0,0
13957,False,3,4,4,0,4
13958,False,5,6,9,0,9
13959,False,6,7,30,4,26
13960,False,10,11,6,1,5
13961,False,1,2,0,0,0
13962,False,2,3,2,0,2
13963,False,2,3,0,0,0
13964,False,8,9,11,0,11
13965,False,4,5,2,0,2
13966,False,3,4,0,0,0
13967,False,2,3,3,0,3
13968,False,2,3,0,0,0
13969,False,7,8,3,0,3
13970,False,3,4,1,0,1
13971,False,7,8,28,1,27
13972,False,4,5,0,0,0
13973,False,2,3,1,0,1
13974,False,7,8,26,2,24
13975,False,6,7,3,0,3
13976,False,1,2,0,0,0
13977,False,9,10,2,0,2
13978,False,3,4,0,0,0
13979,False,3,4,0,0,0
13980,False,8,9,7,0,7
13981,False,1,2,0,0,0
13982,False,7,8,5,0,5
13983,False,1,2,0,0,0
13984,False,3,4,2,0,2
13985,False,4,5,5,0,5
13986,False,9,10,0,0,0
13987,False,7,8,0,0,0
13988,False,2,3,0,0,0
13989,False,5,6,13,0,13
13990,False,1,2,0,0,0
13991,False,1,2,0,0,0
13992,False,3,4,3,0,3
13993,False,1,2,0,0,0
13994,False,2,3,3,0,3
13995,False,4,5,1,0,1
13996,False,7,8,3,0,3
13997,False,6,7,10,0,10
13998,False,1,2,0,0,0
13999,False,4,5,3,0,3
14000,False,3,4,8,0,8
14001,False,2,3,1,0,1
14002,False,6,7,26,3,23
14003,False,3,4,1,0,1
14004,False,1,2,0,0,0
14005,False,4,5,0,0,0
14006,False,7,8,0,0,0
14007,False,6,7,1,0,1
14008,False,1,2,0,0,0
14009,False,6,7,4,0,4
14010,False,12,13,1,0,1
14011,False,5,6,3,0,3
14012,False,10,11,9,0,9
14013,False,9,10,4,0,4
14014,False,3,4,2,0,2
14015,False,1,2,4,2,2
14016,False,3,4,1,0,1
14017,False,2,3,0,0,0
14018,False,9,10,1,0,1
14019,False,5,6,40,1,39
14020,False,5,6,2,0,2
14021,False,2,3,43,0,43
14022,False,2,3,0,0,0
14023,False,1,2,80,0,80
14024,False,4,5,7,0,7
14025,False,5,6,5,0,5
14026,False,3,4,1,0,1
14027,False,3,4,4,0,4
14028,False,4,5,3,0,3
14029,False,3,4,3,0,3
14030,False,5,6,5,0,5
14031,False,2,3,2,0,2
14032,False,2,3,4,0,4
14033,False,5,6,5,0,5
14034,False,4,5,1,0,1
14035,False,2,3,0,0,0
14036,False,3,4,2,0,2
14037,False,2,3,0,0,0
14038,False,15,16,31,1,30
14039,False,1,2,0,0,0
14040,False,7,8,10,0,10
14041,False,5,6,3,0,3
14042,False,1,2,0,0,0
14043,False,1,2,0,0,0
14044,False,3,4,2,0,2
14045,False,2,3,0,0,0
14046,False,3,4,0,0,0
14047,False,8,9,2,1,1
14048,False,5,6,9,0,9
14049,False,4,5,1,0,1
14050,False,3,4,0,0,0
14051,False,4,5,5,1,4
14052,False,1,2,2,0,2
14053,False,2,3,0,0,0
14054,False,4,5,5,0,5
14055,False,4,5,1,0,1
14056,False,10,11,0,0,0
14057,False,3,4,3,0,3
14058,False,5,6,3,0,3
14059,False,10,11,4,0,4
14060,False,1,2,0,0,0
14061,False,11,12,5,0,5
14062,False,8,9,1,0,1
14063,False,5,6,5,0,5
14064,False,2,3,0,0,0
14065,False,2,3,45,0,45
14066,False,1,2,0,0,0
14067,False,6,7,4,2,2
14068,False,5,6,3,0,3
14069,False,2,3,2,0,2
14070,False,11,12,6,0,6
14071,False,4,5,3,0,3
14072,False,4,5,5,0,5
14073,False,8,9,3,0,3
14074,False,4,5,1,0,1
14075,False,2,3,0,0,0
14076,False,6,7,12,1,11
14077,False,2,3,1,0,1
14078,False,6,7,27,0,27
14079,False,8,9,16,0,16
14080,False,4,5,2,0,2
14081,False,6,7,27,2,25
14082,False,3,4,2,0,2
14083,False,2,3,0,0,0
14084,False,3,4,1,0,1
14085,False,3,4,2,0,2
14086,False,1,2,1,0,1
14087,False,1,2,2,0,2
14088,False,1,2,0,0,0
14089,False,1,2,1,0,1
14090,False,4,5,14,0,14
14091,False,1,2,0,0,0
14092,False,2,3,3,0,3
14093,False,2,3,1,0,1
14094,False,1,2,0,0,0
14095,False,3,4,2,0,2
14096,False,4,5,1,0,1
14097,False,8,9,10,0,10
14098,False,1,2,2,0,2
14099,False,2,3,1,0,1
14100,False,2,3,1,0,1
14101,False,3,4,2,0,2
14102,False,6,7,1,0,1
14103,False,3,4,53,6,47
14104,False,1,2,0,0,0
14105,False,8,9,30,2,28
14106,False,1,2,0,0,0
14107,False,2,3,1,0,1
14108,False,4,5,1,0,1
14109,False,3,4,5,0,5
14110,False,7,8,2,0,2
14111,False,1,2,1,0,1
14112,False,7,8,6,0,6
14113,False,5,6,6,0,6
14114,False,2,3,2,0,2
14115,False,1,2,0,0,0
14116,False,4,5,4,0,4
14117,False,7,8,4,1,3
14118,False,3,4,3,0,3
14119,False,1,2,0,0,0
14120,False,6,7,1,0,1
14121,False,4,5,2,0,2
14122,False,1,2,0,0,0
14123,False,5,6,4,0,4
14124,False,1,2,0,0,0
14125,False,2,3,0,0,0
14126,False,7,8,33,0,33
14127,False,3,4,0,0,0
14128,False,9,10,7,0,7
14129,False,2,3,2,0,2
14130,False,4,5,0,0,0
14131,False,1,2,0,0,0
14132,False,6,7,1,0,1
14133,False,2,3,0,0,0
14134,False,3,4,3,0,3
14135,False,1,2,0,0,0
14136,False,6,7,4,0,4
14137,False,1,2,0,0,0
14138,False,5,6,4,0,4
14139,False,3,4,45,0,45
14140,False,1,2,1,0,1
14141,False,4,5,6,0,6
14142,False,3,4,32,0,32
14143,False,3,4,2,0,2
14144,False,1,2,0,0,0
14145,False,3,4,0,0,0
14146,False,2,3,0,0,0
14147,False,3,4,3,0,3
14148,False,2,3,0,0,0
14149,False,2,3,2,0,2
14150,False,4,5,0,0,0
14151,False,1,2,0,0,0
14152,False,1,2,0,0,0
14153,False,1,2,0,0,0
14154,False,2,3,1,0,1
14155,False,6,7,9,0,9
14156,False,3,4,2,0,2
14157,False,4,5,0,0,0
14158,False,5,6,9,1,8
14159,False,1,2,0,0,0
14160,False,3,4,9,0,9
14161,False,10,11,4,0,4
14162,False,2,3,0,0,0
14163,False,1,2,0,0,0
14164,False,5,6,1,0,1
14165,False,4,5,0,0,0
14166,False,6,7,4,0,4
14167,False,1,2,0,0,0
14168,False,5,6,2,0,2
14169,False,1,2,80,0,80
14170,False,4,5,0,0,0
14171,False,1,2,1,0,1
14172,False,12,13,8,0,8
14173,False,1,2,0,0,0
14174,False,8,9,7,0,7
14175,False,2,3,0,0,0
14176,False,5,6,5,0,5
14177,False,4,5,2,0,2
14178,False,8,9,25,0,25
14179,False,2,3,0,0,0
14180,False,4,5,1,0,1
14181,False,4,5,2,0,2
14182,False,2,3,1,0,1
14183,False,1,2,1,0,1
14184,False,1,2,0,0,0
14185,False,1,2,5,0,5
14186,False,2,3,1,0,1
14187,False,1,2,0,0,0
14188,False,3,4,0,0,0
14189,False,3,4,2,0,2
14190,False,1,2,2,0,2
14191,False,4,5,3,1,2
14192,False,1,2,0,0,0
14193,False,4,5,0,0,0
14194,False,3,4,2,0,2
14195,False,1,2,6,0,6
14196,False,2,3,3,0,3
14197,False,9,10,4,0,4
14198,False,1,2,0,0,0
14199,False,7,8,0,0,0
14200,False,3,4,0,0,0
14201,False,1,2,1,0,1
14202,False,1,2,1,0,1
14203,False,6,7,5,0,5
14204,False,1,2,1,0,1
14205,False,6,7,30,4,26
14206,False,4,5,7,0,7
14207,False,1,2,0,0,0
14208,False,4,5,2,0,2
14209,False,4,5,26,0,26
14210,False,1,2,0,0,0
14211,False,2,3,0,0,0
14212,False,3,4,37,0,37
14213,False,3,4,4,0,4
14214,False,3,4,2,0,2
14215,False,4,5,2,0,2
14216,False,1,2,0,0,0
14217,False,1,2,0,0,0
14218,False,1,2,0,0,0
14219,False,3,4,0,0,0
14220,False,1,2,0,0,0
14221,False,2,3,3,0,3
14222,False,8,9,3,0,3
14223,False,5,6,10,0,10
14224,False,2,3,4,0,4
14225,False,7,8,3,1,2
14226,False,5,6,2,0,2
14227,False,2,3,0,0,0
14228,False,2,3,0,0,0
14229,False,1,2,0,0,0
14230,False,8,9,5,0,5
14231,False,1,2,0,0,0
14232,False,1,2,0,0,0
14233,False,2,3,0,0,0
14234,False,1,2,2,0,2
14235,False,3,4,8,0,8
14236,False,1,2,0,0,0
14237,False,1,2,0,0,0
14238,False,2,3,0,0,0
14239,False,3,4,13,0,13
14240,False,1,2,0,0,0
14241,False,3,4,33,0,33
14242,False,1,2,0,0,0
14243,False,2,3,0,0,0
14244,False,2,3,2,0,2
14245,False,1,2,0,0,0
14246,False,1,2,0,0,0
14247,False,6,7,29,0,29
14248,False,1,2,0,0,0
14249,False,1,2,0,0,0
14250,False,1,2,3,0,3
14251,False,2,3,1,0,1
14252,False,1,2,2,0,2
14253,False,1,2,0,0,0
14254,False,3,4,1,0,1
14255,False,2,3,0,0,0
14256,False,1,2,0,0,0
14257,False,4,5,3,0,3
14258,False,2,3,0,0,0
14259,False,1,2,0,0,0
14260,False,2,3,4,0,4
14261,False,1,2,0,0,0
14262,False,2,3,0,0,0
14263,False,1,2,4,0,4
14264,False,4,5,1,0,1
14265,False,3,4,1,0,1
14266,False,2,3,3,0,3
14267,False,2,3,0,0,0
14268,False,3,4,3,0,3
14269,False,1,2,0,0,0
14270,False,1,2,0,0,0
14271,False,1,2,2,0,2
14272,False,1,2,0,0,0
14273,False,1,2,0,0,0
14274,False,5,6,4,0,4
14275,False,3,4,2,0,2
14276,False,1,2,0,0,0
14277,False,2,3,2,0,2
14278,False,6,7,3,0,3
14279,False,1,2,0,0,0
14280,False,1,2,3,0,3
14281,False,4,5,3,0,3
14282,False,7,8,1,0,1
14283,False,3,4,0,0,0
14284,False,3,4,0,0,0
14285,False,1,2,0,0,0
14286,False,1,2,0,0,0
14287,False,3,4,1,0,1
14288,False,5,6,0,0,0
14289,False,3,4,0,0,0
14290,False,3,4,0,0,0
14291,False,1,2,0,0,0
14292,False,4,5,2,0,2
14293,False,1,2,0,0,0
14294,False,1,2,0,0,0
14295,False,2,3,2,0,2
14296,False,1,2,0,0,0
14297,False,6,7,0,0,0
14298,False,1,2,0,0,0
14299,False,1,2,0,0,0
14300,False,4,5,4,0,4
14301,False,1,2,0,0,0
14302,False,1,2,0,0,0
14303,False,2,3,1,0,1
14304,False,3,4,0,0,0
14305,False,3,4,0,0,0
14306,False,3,4,3,0,3
14307,False,6,7,25,11,14
14308,False,1,2,0,0,0
14309,False,3,4,0,0,0
14310,False,3,4,0,0,0
14311,False,1,2,0,0,0
14312,False,5,6,81,0,81
14313,False,1,2,0,0,0
14314,False,3,4,9,0,9
14315,False,1,2,1,0,1
14316,False,2,3,1,0,1
14317,False,1,2,1,0,1
14318,False,1,2,1,0,1
14319,False,5,6,3,0,3
14320,False,3,4,8,0,8
14321,False,3,4,0,0,0
14322,False,1,2,0,0,0
14323,False,2,3,2,0,2
14324,False,2,3,0,0,0
14325,False,1,2,0,0,0
14326,False,1,2,2,0,2
14327,False,1,2,1,0,1
14328,False,1,2,0,0,0
14329,False,6,7,3,0,3
14330,False,3,4,1,0,1
14331,False,4,5,2,0,2
14332,False,3,4,1,0,1
14333,False,2,3,1,0,1
14334,False,2,3,2,0,2
14335,False,2,3,0,0,0
14336,False,2,3,0,0,0
14337,False,4,5,2,0,2
14338,False,2,3,1,0,1
14339,False,2,3,5,0,5
14340,False,2,3,32,0,32
14341,False,3,4,2,0,2
14342,False,3,4,0,0,0
14343,False,1,2,0,0,0
14344,False,3,4,12,0,12
14345,False,1,2,0,0,0
14346,False,3,4,1,0,1
14347,False,1,2,2,0,2
14348,False,2,3,2,0,2
14349,False,1,2,0,0,0
14350,False,1,2,0,0,0
14351,False,3,4,38,0,38
14352,False,2,3,0,0,0
14353,False,3,4,4,0,4
14354,False,1,2,2,0,2
14355,False,1,2,0,0,0
14356,False,1,2,0,0,0
14357,False,2,3,1,0,1
14358,False,1,2,0,0,0
14359,False,1,2,0,0,0
14360,False,1,2,1,0,1
14361,False,4,5,0,0,0
14362,False,1,2,0,0,0
14363,False,1,2,0,0,0
14364,False,1,2,1,0,1
14365,False,2,3,0,0,0
14366,False,4,5,0,0,0
14367,False,1,2,0,0,0
14368,False,1,2,0,0,0
14369,False,3,4,5,0,5
14370,False,2,3,2,0,2
14371,False,2,3,4,0,4
14372,False,2,3,2,0,2
14373,False,2,3,2,0,2
14374,False,1,2,1,0,1
14375,False,1,2,0,0,0
14376,False,3,4,1,0,1
14377,False,1,2,0,0,0
14378,False,3,4,0,0,0
14379,False,1,2,2,0,2
14380,False,5,6,31,0,31
14381,False,2,3,6,0,6
14382,False,2,3,0,0,0
14383,False,1,2,1,0,1
14384,False,1,2,1,0,1
14385,False,1,2,0,0,0
14386,False,1,2,2,0,2
14387,False,1,2,0,0,0
14388,False,1,2,0,0,0
14389,False,2,3,0,0,0
14390,False,1,2,0,0,0
14391,False,1,2,80,0,80
14392,False,1,2,0,0,0
14393,False,3,4,2,0,2
14394,False,1,2,0,0,0
14395,False,1,2,80,0,80
14396,False,2,3,0,0,0
14397,False,2,3,0,0,0
14398,False,2,3,3,0,3
14399,False,2,3,0,0,0
14400,False,1,2,0,0,0
14401,False,1,2,2,0,2
14402,False,1,2,0,0,0
14403,False,2,3,0,0,0
14404,False,2,3,0,0,0
14405,False,2,3,0,0,0
14406,False,1,2,0,0,0
14407,False,2,3,0,0,0
14408,False,1,2,0,0,0
14409,False,1,2,0,0,0
14410,False,1,2,0,0,0
14411,False,2,3,0,0,0
14412,False,1,2,0,0,0
14413,False,1,2,1,0,1
14414,False,1,2,0,0,0
14415,False,1,2,0,0,0
14416,False,2,3,3,0,3
14417,False,1,2,0,0,0
14418,False,1,2,0,0,0
14419,False,1,2,1,0,1
14420,False,1,2,0,0,0
14421,False,1,2,0,0,0
14422,False,1,2,1,0,1
14423,False,1,2,0,0,0
14424,False,1,2,0,0,0
14425,False,2,3,0,0,0
14426,False,4,5,3,0,3
14427,False,1,2,0,0,0
14428,False,1,2,0,0,0
14429,False,1,2,2,0,2
14430,False,1,2,0,0,0
14431,False,1,2,2,0,2
14432,False,1,2,0,0,0
14433,False,1,2,0,0,0
14434,False,1,2,2,0,2
14435,False,1,2,3,0,3
14436,False,1,2,0,0,0
14437,False,1,2,1,0,1
14438,False,1,2,0,0,0
14439,False,1,2,0,0,0
14440,False,2,3,0,0,0
14441,False,1,2,1,0,1
14442,False,1,2,0,0,0
14443,False,1,2,0,0,0
14444,False,1,2,0,0,0
14445,False,1,2,0,0,0
14446,False,1,2,0,0,0
14447,False,1,2,0,0,0
14448,False,1,2,80,0,80
14449,False,1,2,0,0,0
14450,False,2,3,2,0,2
14451,False,2,3,0,0,0
14452,False,1,2,0,0,0
14453,False,1,2,0,0,0
14454,False,1,2,0,0,0
14455,False,1,2,0,0,0
14456,False,3,4,2,0,2
14457,False,2,3,0,0,0
14458,False,2,3,2,0,2
14459,False,1,2,0,0,0
14460,False,3,4,2,0,2
14461,False,1,2,0,0,0
14462,False,1,2,0,0,0
14463,False,1,2,0,0,0
14464,False,1,2,0,0,0
14465,False,1,2,80,0,80
14466,False,1,2,0,0,0
14467,False,1,2,0,0,0
14468,False,1,2,0,0,0
14469,False,1,2,0,0,0
14470,False,2,3,1,0,1
14471,False,1,2,80,0,80
14472,False,1,2,0,0,0
14473,False,1,2,0,0,0
14474,False,1,2,0,0,0
14475,False,1,2,0,0,0
14476,False,1,2,0,0,0
14477,False,1,2,0,0,0
14478,False,1,2,0,0,0
14479,False,2,3,3,0,3
14480,False,2,3,3,0,3
14481,False,1,2,0,0,0
14482,False,1,2,0,0,0
14483,False,1,2,0,0,0
14484,False,1,2,1,0,1
14485,False,1,2,80,0,80
14486,False,1,2,0,0,0
14487,False,1,2,0,0,0
14488,False,1,2,0,0,0
14489,False,1,2,0,0,0
14490,False,1,2,0,0,0
14491,False,1,2,80,0,80
14492,False,1,2,80,0,80
14493,False,1,2,80,0,80
14494,False,2,3,5,0,5
14495,False,1,2,0,0,0
14496,False,1,2,0,0,0
14497,False,1,2,0,0,0
14498,False,1,2,0,0,0
14499,False,1,2,0,0,0
14500,False,1,2,0,0,0
14501,False,2,3,4,0,4
14502,False,1,2,2,0,2
14503,False,1,2,3,0,3
14504,False,1,2,0,0,0
14505,False,1,2,0,0,0
14506,False,1,2,0,0,0
